premise hypothesis  label
这条路是丑陋的。	这个单词是丑陋的。	not_entailment
这个单词是丑陋的。	这条路是丑陋的。	not_entailment
这个抽水机是高效的。	DNA是高效的。	not_entailment
DNA是高效的。	这个抽水机是高效的。	not_entailment
这片草地是漂亮的。	这片大海是漂亮的。	not_entailment
这片大海是漂亮的。	这片草地是漂亮的。	not_entailment
这间房屋是丑陋的。	这个人是丑陋的。	not_entailment
这个人是丑陋的。	这间房屋是丑陋的。	not_entailment
这天气是寒冷的。	这个二月是寒冷的。	not_entailment
这个二月是寒冷的。	这天气是寒冷的。	not_entailment
这首歌曲是合适的。	这个美国人是合适的。	not_entailment
这个美国人是合适的。	这首歌曲是合适的。	not_entailment
这头水牛是肥胖的。	这名男士是肥胖的。	not_entailment
这名男士是肥胖的。	这头水牛是肥胖的。	not_entailment
这只猫是快乐的。	这名老板是快乐的。	not_entailment
这名老板是快乐的。	这只猫是快乐的。	not_entailment
这个回答是聪明的。	这只知更鸟是聪明的。	not_entailment
这只知更鸟是聪明的。	这个回答是聪明的。	not_entailment
这个男人是滑稽的。	这个真相是滑稽的。	not_entailment
这个真相是滑稽的。	这个男人是滑稽的。	not_entailment
这底部是干净的。	这个湖是干净的。	not_entailment
这个湖是干净的。	这底部是干净的。	not_entailment
这个站台是宝贵的。	这块布料是宝贵的。	not_entailment
这块布料是宝贵的。	这个站台是宝贵的。	not_entailment
这个后果是难受的。	这首音乐是难受的。	not_entailment
这首音乐是难受的。	这个后果是难受的。	not_entailment
这个陶工是担心的。	这个平民是担心的。	not_entailment
这个平民是担心的。	这个陶工是担心的。	not_entailment
这个结合体是迷人的。	这里面是迷人的。	not_entailment
这里面是迷人的。	这个结合体是迷人的。	not_entailment
这现实是恐怖的。	这个事情是恐怖的。	not_entailment
这个事情是恐怖的。	这现实是恐怖的。	not_entailment
这个办公室是拥挤的。	这个世界是拥挤的。	not_entailment
这个世界是拥挤的。	这个办公室是拥挤的。	not_entailment
这间酒吧是活跃的。	这个磨光机是活跃的。	not_entailment
这个磨光机是活跃的。	这间酒吧是活跃的。	not_entailment
这钱是肮脏的。	这天孔是肮脏的。	not_entailment
这天孔是肮脏的。	这钱是肮脏的。	not_entailment
这次休息是短暂的。	这个后果是短暂的。	not_entailment
这个后果是短暂的。	这次休息是短暂的。	not_entailment
这个后果是奇怪的。	这个利福尼亚人是奇怪的。	not_entailment
这个利福尼亚人是奇怪的。	这个后果是奇怪的。	not_entailment
这水果是美味的。	这只鸡是美味的。	not_entailment
这只鸡是美味的。	这水果是美味的。	not_entailment
这个购物者是聪明的。	这个男孩是聪明的。	not_entailment
这个男孩是聪明的。	这个购物者是聪明的。	not_entailment
这个戏剧是愚蠢的。	这个圣诞老人是愚蠢的。	not_entailment
这个圣诞老人是愚蠢的。	这个戏剧是愚蠢的。	not_entailment
这种类型是少见的。	这委内瑞拉人是少见的。	not_entailment
这委内瑞拉人是少见的。	这种类型是少见的。	not_entailment
这个东西是美味的。	这次烹饪是美味的。	not_entailment
这次烹饪是美味的。	这个东西是美味的。	not_entailment
这个会议是糟糕的。	这次降温的是糟糕的。	not_entailment
这次降温的是糟糕的。	这个会议是糟糕的。	not_entailment
这个集市是活跃的。	这个酒吧是活跃的。	not_entailment
这个酒吧是活跃的。	这个集市是活跃的。	not_entailment
这个梦是怪异的。	这部电影是怪异的。	not_entailment
这部电影是怪异的。	这个梦是怪异的。	not_entailment
亚历山大是附近的。	吉米一家是附近的。	not_entailment
吉米一家是附近的。	亚历山大是附近的。	not_entailment
这个海滩是肮脏的。	这个厨房是肮脏的。	not_entailment
这个厨房是肮脏的。	这个海滩是肮脏的。	not_entailment
这天是寒冷的。	这碗汤是寒冷的。	not_entailment
这碗汤是寒冷的。	这天是寒冷的。	not_entailment
这间别墅是特别的。	这片树林是特别的。	not_entailment
这片树林是特别的。	这间别墅是特别的。	not_entailment
这个设计是迷人的。	这些供给是迷人的。	not_entailment
这些供给是迷人的。	这个设计是迷人的。	not_entailment
这个峡谷是美丽的。	这加勒比海的是美丽的。	not_entailment
这加勒比海的是美丽的。	这个峡谷是美丽的。	not_entailment
亚历山大是年轻的。	阿根廷是年轻的。	not_entailment
阿根廷是年轻的。	亚历山大是年轻的。	not_entailment
这个收藏品是个人的。	这家东芝是个人的。	not_entailment
这家东芝是个人的。	这个收藏品是个人的。	not_entailment
这间监狱是拥挤的。	这个竞技场是拥挤的。	not_entailment
这个竞技场是拥挤的。	这间监狱是拥挤的。	not_entailment
这本书是滑稽的。	吉米一家是滑稽的。	not_entailment
吉米一家是滑稽的。	这本书是滑稽的。	not_entailment
这次死亡是快速的。	夏洛特一家是快速的。	not_entailment
夏洛特一家是快速的。	这次死亡是快速的。	not_entailment
史密斯一家是特别的。	这次机会是特别的。	not_entailment
这次机会是特别的。	史密斯一家是特别的。	not_entailment
这个公司是宝贵的。	这个档案文件是宝贵的。	not_entailment
这个档案文件是宝贵的。	这个公司是宝贵的。	not_entailment
这个客户是成熟的。	这个集市是成熟的。	not_entailment
这个集市是成熟的。	这个客户是成熟的。	not_entailment
这个系统是虚弱的。	这个陶匠是虚弱的。	not_entailment
这个陶匠是虚弱的。	这个系统是虚弱的。	not_entailment
这片沙漠是干燥的。	这个九月是干燥的。	not_entailment
这个九月是干燥的。	这片沙漠是干燥的。	not_entailment
这碗汤是寒冷的。	这只手是寒冷的。	not_entailment
这只手是寒冷的。	这碗汤是寒冷的。	not_entailment
这首歌曲是滑稽的。	这商业模式是滑稽的。	not_entailment
这商业模式是滑稽的。	这首歌曲是滑稽的。	not_entailment
这个许可证是个人的。	这个标注是个人的。	not_entailment
这个标注是个人的。	这个许可证是个人的。	not_entailment
路易斯一家是漂亮的。	这颜色是漂亮的。	not_entailment
这颜色是漂亮的。	路易斯一家是漂亮的。	not_entailment
这部法律是丑陋的。	这个面具是丑陋的。	not_entailment
这个面具是丑陋的。	这部法律是丑陋的。	not_entailment
这个外表是愚蠢的。	这次挥霍是愚蠢的。	not_entailment
这次挥霍是愚蠢的。	这个外表是愚蠢的。	not_entailment
这个解决方案是不错的。	悉尼是不错的。	not_entailment
悉尼是不错的。	这个解决方案是不错的。	not_entailment
这个原因是特别的。	这个形状是特别的。	not_entailment
这个形状是特别的。	这个原因是特别的。	not_entailment
这个消费者是成熟的。	这个作者是成熟的。	not_entailment
这个作者是成熟的。	这个消费者是成熟的。	not_entailment
这份工作是宝贵的。	这个公司是宝贵的。	not_entailment
这个公司是宝贵的。	这份工作是宝贵的。	not_entailment
这个陶器是著名的。	这个笔者是著名的。	not_entailment
这个笔者是著名的。	这个陶器是著名的。	not_entailment
这个机场是拥挤的。	这个餐馆是拥挤的。	not_entailment
这个餐馆是拥挤的。	这个机场是拥挤的。	not_entailment
这个手杖是糟糕的。	这个消息是糟糕的。	not_entailment
这个消息是糟糕的。	这个手杖是糟糕的。	not_entailment
这个地板是暗淡的。	这个灯是暗淡的。	not_entailment
这个灯是暗淡的。	这个地板是暗淡的。	not_entailment
这种水果是香甜的。	这道菜是香甜的。	not_entailment
这道菜是香甜的。	这种水果是香甜的。	not_entailment
这首歌曲是怪异的。	这个公园是怪异的。	not_entailment
这个公园是怪异的。	这首歌曲是怪异的。	not_entailment
这里面是怪异的。	这外观是怪异的。	not_entailment
这外观是怪异的。	这里面是怪异的。	not_entailment
这土壤是潮湿的。	这条大街是潮湿的。	not_entailment
这条大街是潮湿的。	这土壤是潮湿的。	not_entailment
这个消费者是高效的。	这个计算机是高效的。	not_entailment
这个计算机是高效的。	这个消费者是高效的。	not_entailment
这个花店是个人的。	这间别墅是个人的。	not_entailment
这间别墅是个人的。	这个花店是个人的。	not_entailment
这种蓝色是漂亮的。	这个峡谷是漂亮的。	not_entailment
这个峡谷是漂亮的。	这种蓝色是漂亮的。	not_entailment
这个解决方案是快速的。	这次驾驶是快速的。	not_entailment
这次驾驶是快速的。	这个解决方案是快速的。	not_entailment
这次罪行是暴力的。	亚马逊是暴力的。	not_entailment
亚马逊是暴力的。	这次罪行是暴力的。	not_entailment
这个代表是误导的。	这个广告是误导的。	not_entailment
这个广告是误导的。	这个代表是误导的。	not_entailment
这些牛肉是丰富的。	这些娱乐片是丰富的。	not_entailment
这些娱乐片是丰富的。	这些牛肉是丰富的。	not_entailment
这些看法是悲观的。	这个梦是悲观的。	not_entailment
这个梦是悲观的。	这些看法是悲观的。	not_entailment
这种药物是昂贵的。	这个硬件是昂贵的。	not_entailment
这个硬件是昂贵的。	这种药物是昂贵的。	not_entailment
这片树林是小的。	这个村庄是小的。	not_entailment
这个村庄是小的。	这片树林是小的。	not_entailment
这块混凝土是潮湿的。	这个世界是潮湿的。	not_entailment
这个世界是潮湿的。	这块混凝土是潮湿的。	not_entailment
这个小孩是能干的。	这个军官是能干的。	not_entailment
这个军官是能干的。	这个小孩是能干的。	not_entailment
史密斯一家是古老的。	这个助行器是古老的。	not_entailment
这个助行器是古老的。	史密斯一家是古老的。	not_entailment
这名领导是虚弱的。	路易斯一家是虚弱的。	not_entailment
路易斯一家是虚弱的。	这名领导是虚弱的。	not_entailment
这语气是悲伤的。	这个圣诞节是悲伤的。	not_entailment
这个圣诞节是悲伤的。	这语气是悲伤的。	not_entailment
这块脂肪是肥胖的。	拉塞尔是肥胖的。	not_entailment
拉塞尔是肥胖的。	这块脂肪是肥胖的。	not_entailment
这个计算机是愚蠢的。	这个穆斯林是愚蠢的。	not_entailment
这个穆斯林是愚蠢的。	这个计算机是愚蠢的。	not_entailment
这个计划是有趣的。	这个世界是有趣的。	not_entailment
这个世界是有趣的。	这个计划是有趣的。	not_entailment
这个dvd是损坏的。	这个计算机是损坏的。	not_entailment
这个计算机是损坏的。	这个dvd是损坏的。	not_entailment
这个镜子是丑陋的。	月球是丑陋的。	not_entailment
月球是丑陋的。	这个镜子是丑陋的。	not_entailment
史密斯一家是古怪的。	这种情绪是古怪的。	not_entailment
这种情绪是古怪的。	史密斯一家是古怪的。	not_entailment
这种技术是昂贵的。	这个瓷器是昂贵的。	not_entailment
这个瓷器是昂贵的。	这种技术是昂贵的。	not_entailment
这种水果是特别的。	这密歇根是特别的。	not_entailment
这密歇根是特别的。	这种水果是特别的。	not_entailment
这段历史是美丽的。	这片树林是美丽的。	not_entailment
这片树林是美丽的。	这段历史是美丽的。	not_entailment
这个戒指是宝贵的。	这个手册是宝贵的。	not_entailment
这个手册是宝贵的。	这个戒指是宝贵的。	not_entailment
这个领导是误导的。	这个广告是误导的。	not_entailment
这个广告是误导的。	这个领导是误导的。	not_entailment
这黑暗的是恐怖的。	这个场景是恐怖的。	not_entailment
这个场景是恐怖的。	这黑暗的是恐怖的。	not_entailment
这个情绪是活泼的。	这群人是活泼的。	not_entailment
这群人是活泼的。	这个情绪是活泼的。	not_entailment
亚历山大是疲倦的。	这个机器是疲倦的。	not_entailment
这个机器是疲倦的。	亚历山大是疲倦的。	not_entailment
这个案例是有趣的。	这个结果是有趣的。	not_entailment
这个结果是有趣的。	这个案例是有趣的。	not_entailment
这条小溪是漂亮的。	这片草地是漂亮的。	not_entailment
这片草地是漂亮的。	这条小溪是漂亮的。	not_entailment
这个大脑是肥胖的。	这头狼是肥胖的。	not_entailment
这头狼是肥胖的。	这个大脑是肥胖的。	not_entailment
这次战斗是激烈的。	这次竞争是激烈的。	not_entailment
这次竞争是激烈的。	这次战斗是激烈的。	not_entailment
这个蓝牙是好用的。	这个机器是好用的。	not_entailment
这个机器是好用的。	这个蓝牙是好用的。	not_entailment
这个情况是有趣的。	这段休息是有趣的。	not_entailment
这段休息是有趣的。	这个情况是有趣的。	not_entailment
这个真相是宝贵的。	这个瓷器是宝贵的。	not_entailment
这个瓷器是宝贵的。	这个真相是宝贵的。	not_entailment
这个机器是聪明的。	帕克是聪明的。	not_entailment
帕克是聪明的。	这个机器是聪明的。	not_entailment
这个装饰是糟糕的。	这个后果是糟糕的。	not_entailment
这个后果是糟糕的。	这个装饰是糟糕的。	not_entailment
这个世界是糟糕的。	这些费用是糟糕的。	not_entailment
这些费用是糟糕的。	这个世界是糟糕的。	not_entailment
这个差别是糟糕的。	这个声音是糟糕的。	not_entailment
这个声音是糟糕的。	这个差别是糟糕的。	not_entailment
这台计算机是高效的。	史密斯一家是高效的。	not_entailment
史密斯一家是高效的。	这台计算机是高效的。	not_entailment
这台磨光机是漂亮的。	这间别墅是漂亮的。	not_entailment
这间别墅是漂亮的。	这台磨光机是漂亮的。	not_entailment
这边境是寒冷的。	这个四月是寒冷的。	not_entailment
这个四月是寒冷的。	这边境是寒冷的。	not_entailment
这天气是潮湿的。	这个地板是潮湿的。	not_entailment
这个地板是潮湿的。	这天气是潮湿的。	not_entailment
这瓶牛奶是寒冷的。	这个房间是寒冷的。	not_entailment
这个房间是寒冷的。	这瓶牛奶是寒冷的。	not_entailment
这支军队是疲倦的。	这个医生是疲倦的。	not_entailment
这个医生是疲倦的。	这支军队是疲倦的。	not_entailment
这个问题是容易的。	这个目标是容易的。	not_entailment
这个目标是容易的。	这个问题是容易的。	not_entailment
这个单词是肥胖的。	吉米一家是肥胖的。	not_entailment
吉米一家是肥胖的。	这个单词是肥胖的。	not_entailment
这条路是肮脏的。	这个地板是肮脏的。	not_entailment
这个地板是肮脏的。	这条路是肮脏的。	not_entailment
这种疾病是少见的。	这种情况是少见的。	not_entailment
这种情况是少见的。	这种疾病是少见的。	not_entailment
这神谕是神奇的。	这块电池是神奇的。	not_entailment
这块电池是神奇的。	这神谕是神奇的。	not_entailment
这个故事是有趣的。	这个收藏品是有趣的。	not_entailment
这个收藏品是有趣的。	这个故事是有趣的。	not_entailment
这名美食家是饥饿的。	夏洛特是饥饿的。	not_entailment
夏洛特是饥饿的。	这名美食家是饥饿的。	not_entailment
这种粉红色是漂亮的。	珍妮弗是漂亮的。	not_entailment
珍妮弗是漂亮的。	这种粉红色是漂亮的。	not_entailment
这个特许经销权是宝贵的。	这片树林是宝贵的。	not_entailment
这片树林是宝贵的。	这个特许经销权是宝贵的。	not_entailment
这个灯是暗淡的。	这个八月是暗淡的。	not_entailment
这个八月是暗淡的。	这个灯是暗淡的。	not_entailment
这条河是干燥的。	吉米一家是干燥的。	not_entailment
吉米一家是干燥的。	这条河是干燥的。	not_entailment
这个原因是简单的。	这工作是简单的。	not_entailment
这工作是简单的。	这个原因是简单的。	not_entailment
这束光是暗淡的。	这个门厅是暗淡的。	not_entailment
这个门厅是暗淡的。	这束光是暗淡的。	not_entailment
这个结尾是快乐的。	这怀俄明州人是快乐的。	not_entailment
这怀俄明州人是快乐的。	这个结尾是快乐的。	not_entailment
这群人是活跃的。	这片树林是活跃的。	not_entailment
这片树林是活跃的。	这群人是活跃的。	not_entailment
这个外表是滑稽的。	这篇文章是滑稽的。	not_entailment
这篇文章是滑稽的。	这个外表是滑稽的。	not_entailment
这个酒店是拥挤的。	这个场景是拥挤的。	not_entailment
这个场景是拥挤的。	这个酒店是拥挤的。	not_entailment
这个图案是特别的。	这河流浅水处是特别的。	not_entailment
这河流浅水处是特别的。	这个图案是特别的。	not_entailment
这个答复是愚蠢的。	这条法律是愚蠢的。	not_entailment
这条法律是愚蠢的。	这个答复是愚蠢的。	not_entailment
这个答复是恐怖的。	这个圣诞老人是恐怖的。	not_entailment
这个圣诞老人是恐怖的。	这个答复是恐怖的。	not_entailment
这次旅行是昂贵的。	这个陶器是昂贵的。	not_entailment
这个陶器是昂贵的。	这次旅行是昂贵的。	not_entailment
这笔钱是大量的。	这次供给是大量的。	not_entailment
这次供给是大量的。	这笔钱是大量的。	not_entailment
这空气是肮脏的。	这块斜纹棉布是肮脏的。	not_entailment
这块斜纹棉布是肮脏的。	这空气是肮脏的。	not_entailment
这现在是必需的。	这过程是必需的。	not_entailment
这过程是必需的。	这现在是必需的。	not_entailment
这个协会是失望的。	夏洛特是失望的。	not_entailment
夏洛特是失望的。	这个协会是失望的。	not_entailment
这首说唱是滑稽的。	这只猫是滑稽的。	not_entailment
这只猫是滑稽的。	这首说唱是滑稽的。	not_entailment
这个世界是虚弱的。	这个环境是虚弱的。	not_entailment
这个环境是虚弱的。	这个世界是虚弱的。	not_entailment
这网络是高效的。	这个工厂是高效的。	not_entailment
这个工厂是高效的。	这网络是高效的。	not_entailment
这些资产是宝贵的。	这个真相是宝贵的。	not_entailment
这个真相是宝贵的。	这些资产是宝贵的。	not_entailment
这次休息是悲伤的。	亚历山大是悲伤的。	not_entailment
亚历山大是悲伤的。	这次休息是悲伤的。	not_entailment
这声铃声是滑稽的。	这个语气是滑稽的。	not_entailment
这个语气是滑稽的。	这声铃声是滑稽的。	not_entailment
这次工作是困难的。	这个公式是困难的。	not_entailment
这个公式是困难的。	这次工作是困难的。	not_entailment
这个陈述是误导的。	这条法律是误导的。	not_entailment
这条法律是误导的。	这个陈述是误导的。	not_entailment
这个偷窥狂是怪异的。	这间酒店是怪异的。	not_entailment
这间酒店是怪异的。	这个偷窥狂是怪异的。	not_entailment
这部电影是愚蠢的。	这个计划是愚蠢的。	not_entailment
这个计划是愚蠢的。	这部电影是愚蠢的。	not_entailment
这次预测是积极的。	这气氛是积极的。	not_entailment
这气氛是积极的。	这次预测是积极的。	not_entailment
这记忆力是宝贵的。	这未来是宝贵的。	not_entailment
这未来是宝贵的。	这记忆力是宝贵的。	not_entailment
这个单词是悲伤的。	这种想法是悲伤的。	not_entailment
这种想法是悲伤的。	这个单词是悲伤的。	not_entailment
这个地板是干燥的。	这片草地是干燥的。	not_entailment
这片草地是干燥的。	这个地板是干燥的。	not_entailment
这陶器是古老的。	这荷兰是古老的。	not_entailment
这荷兰是古老的。	这陶器是古老的。	not_entailment
这块玻璃是干净的。	这内部是干净的。	not_entailment
这内部是干净的。	这块玻璃是干净的。	not_entailment
这首音乐是漂亮的。	这条小溪是漂亮的。	not_entailment
这条小溪是漂亮的。	这首音乐是漂亮的。	not_entailment
史密斯一家是高效的。	这个过程是高效的。	not_entailment
这个过程是高效的。	史密斯一家是高效的。	not_entailment
这部电影是悲伤的。	这次旅行是悲伤的。	not_entailment
这次旅行是悲伤的。	这部电影是悲伤的。	not_entailment
这块镜子是干净的。	这件内衣是干净的。	not_entailment
这件内衣是干净的。	这块镜子是干净的。	not_entailment
这个面包是纤薄的。	这张纸是纤薄的。	not_entailment
这张纸是纤薄的。	这个面包是纤薄的。	not_entailment
这个结论是积极的。	这个强调是积极的。	not_entailment
这个强调是积极的。	这个结论是积极的。	not_entailment
这个结论是合适的。	这个警告是合适的。	not_entailment
这个警告是合适的。	这个结论是合适的。	not_entailment
这个空间是宝贵的。	这英国是宝贵的。	not_entailment
这英国是宝贵的。	这个空间是宝贵的。	not_entailment
这次集中是合适的。	这个珠宝是合适的。	not_entailment
这个珠宝是合适的。	这次集中是合适的。	not_entailment
这空气是潮湿的。	这顶部是潮湿的。	not_entailment
这顶部是潮湿的。	这空气是潮湿的。	not_entailment
这将来是附近的。	这葡萄牙人是附近的。	not_entailment
这葡萄牙人是附近的。	这将来是附近的。	not_entailment
这名医生是干净的。	这间别墅是干净的。	not_entailment
这间别墅是干净的。	这名医生是干净的。	not_entailment
这只猫是滑稽的。	这个情人节是滑稽的。	not_entailment
这个情人节是滑稽的。	这只猫是滑稽的。	not_entailment
这个间谍是聪明的。	拉塞尔是聪明的。	not_entailment
拉塞尔是聪明的。	这个间谍是聪明的。	not_entailment
这个消费者是快乐的。	这个小孩是快乐的。	not_entailment
这个小孩是快乐的。	这个消费者是快乐的。	not_entailment
这种损伤是少见的。	这种短语是少见的。	not_entailment
这种短语是少见的。	这种损伤是少见的。	not_entailment
这对夫妇是快乐的。	这个公爵是快乐的。	not_entailment
这个公爵是快乐的。	这对夫妇是快乐的。	not_entailment
这次投资是宝贵的。	这间别墅是宝贵的。	not_entailment
这间别墅是宝贵的。	这次投资是宝贵的。	not_entailment
这个名称是滑稽的。	这次对话是滑稽的。	not_entailment
这次对话是滑稽的。	这个名称是滑稽的。	not_entailment
这个身份是个人的。	这段经历是个人的。	not_entailment
这段经历是个人的。	这个身份是个人的。	not_entailment
这神谕是智慧的。	这次行动是智慧的。	not_entailment
这次行动是智慧的。	这神谕是智慧的。	not_entailment
这个收藏品是著名的。	这只凤凰是著名的。	not_entailment
这只凤凰是著名的。	这个收藏品是著名的。	not_entailment
这位先生是滑稽的。	这部电影是滑稽的。	not_entailment
这部电影是滑稽的。	这位先生是滑稽的。	not_entailment
这个公爵是迷人的。	悉尼是迷人的。	not_entailment
悉尼是迷人的。	这个公爵是迷人的。	not_entailment
这个邻居是坚韧的。	乔治亚是坚韧的。	not_entailment
乔治亚是坚韧的。	这个邻居是坚韧的。	not_entailment
这种玉米是香甜的。	这水是香甜的。	not_entailment
这水是香甜的。	这种玉米是香甜的。	not_entailment
这种改变是必需的。	这种评价是必需的。	not_entailment
这种评价是必需的。	这种改变是必需的。	not_entailment
这种曲调是可爱的。	这本书是可爱的。	not_entailment
这本书是可爱的。	这种曲调是可爱的。	not_entailment
这个工厂是干净的。	澳大利亚是干净的。	not_entailment
澳大利亚是干净的。	这个工厂是干净的。	not_entailment
这次移动是合适的。	这次使用是合适的。	not_entailment
这次使用是合适的。	这次移动是合适的。	not_entailment
这科学是简单的。	这个配方是简单的。	not_entailment
这个配方是简单的。	这科学是简单的。	not_entailment
这位公爵是疲倦的。	这名平民的是疲倦的。	not_entailment
这名平民的是疲倦的。	这位公爵是疲倦的。	not_entailment
这片树林是可怕的。	这个真相是可怕的。	not_entailment
这个真相是可怕的。	这片树林是可怕的。	not_entailment
这质量是不错的。	这发育是不错的。	not_entailment
这发育是不错的。	这质量是不错的。	not_entailment
这数量是巨大的。	这最低限度是巨大的。	not_entailment
这最低限度是巨大的。	这数量是巨大的。	not_entailment
这杯咖啡是苦涩的。	这杯酒是苦涩的。	not_entailment
这杯酒是苦涩的。	这杯咖啡是苦涩的。	not_entailment
这个机器人是高效的。	这个厨房是高效的。	not_entailment
这个厨房是高效的。	这个机器人是高效的。	not_entailment
这间别墅是有趣的。	这个结论是有趣的。	not_entailment
这个结论是有趣的。	这间别墅是有趣的。	not_entailment
这名农民是疲倦的。	这个灵魂是疲倦的。	not_entailment
这个灵魂是疲倦的。	这名农民是疲倦的。	not_entailment
史密斯一家是不错的。	这经济形势是不错的。	not_entailment
这经济形势是不错的。	史密斯一家是不错的。	not_entailment
这名法官是失望的。	这名读者是失望的。	not_entailment
这名读者是失望的。	这名法官是失望的。	not_entailment
这个男人是迷人的。	这名金发女子是迷人的。	not_entailment
这名金发女子是迷人的。	这个男人是迷人的。	not_entailment
这种感觉是古怪的。	这套西装是古怪的。	not_entailment
这套西装是古怪的。	这种感觉是古怪的。	not_entailment
这个景观是坚固的。	这座桥是坚固的。	not_entailment
这座桥是坚固的。	这个景观是坚固的。	not_entailment
这片刻是凄凉的。	这趋势是凄凉的。	not_entailment
这趋势是凄凉的。	这片刻是凄凉的。	not_entailment
这开始是凄凉的。	这情绪是凄凉的。	not_entailment
这情绪是凄凉的。	这开始是凄凉的。	not_entailment
布兰妮是可爱的。	这匹马是可爱的。	not_entailment
这匹马是可爱的。	布兰妮是可爱的。	not_entailment
这个情节是惊人的。	这个澳大利亚人是惊人的。	not_entailment
这个澳大利亚人是惊人的。	这个情节是惊人的。	not_entailment
这口味是单薄的。	这个男孩是单薄的。	not_entailment
这个男孩是单薄的。	这口味是单薄的。	not_entailment
这部电影是恐怖的。	这个秘密是恐怖的。	not_entailment
这个秘密是恐怖的。	这部电影是恐怖的。	not_entailment
这古罗马人是明智的。	这希腊人是明智的。	not_entailment
这希腊人是明智的。	这古罗马人是明智的。	not_entailment
这项工作是危险的。	这条法律是危险的。	not_entailment
这条法律是危险的。	这项工作是危险的。	not_entailment
这表面是潮湿的。	这片草地是潮湿的。	not_entailment
这片草地是潮湿的。	这表面是潮湿的。	not_entailment
这个作用是高效的。	这个后果是高效的。	not_entailment
这个后果是高效的。	这个作用是高效的。	not_entailment
这段历史是重要的。	荷兰是重要的。	not_entailment
荷兰是重要的。	这段历史是重要的。	not_entailment
这项机械装置是高效的。	这具身体是高效的。	not_entailment
这具身体是高效的。	这项机械装置是高效的。	not_entailment
这个机会是大的。	这个缺口是大的。	not_entailment
这个缺口是大的。	这个机会是大的。	not_entailment
这次行动是快速的。	这个二月是快速的。	not_entailment
这个二月是快速的。	这次行动是快速的。	not_entailment
这个摄像机是干燥的。	这个小孩是干燥的。	not_entailment
这个小孩是干燥的。	这个摄像机是干燥的。	not_entailment
这远景是美丽的。	亚历山大是美丽的。	not_entailment
亚历山大是美丽的。	这远景是美丽的。	not_entailment
这块皮肤是雪白的。	这面墙是雪白的。	not_entailment
这面墙是雪白的。	这块皮肤是雪白的。	not_entailment
这个收藏品是昂贵的。	英国是昂贵的。	not_entailment
英国是昂贵的。	这个收藏品是昂贵的。	not_entailment
这个联盟是古老的。	这座城堡是古老的。	not_entailment
这座城堡是古老的。	这个联盟是古老的。	not_entailment
这个集市是冷清的。	这现状的是冷清的。	not_entailment
这现状的是冷清的。	这个集市是冷清的。	not_entailment
亚历山大是热情的。	这个家庭是热情的。	not_entailment
这个家庭是热情的。	亚历山大是热情的。	not_entailment
这条线是古怪的。	这个角是古怪的。	not_entailment
这个角是古怪的。	这条线是古怪的。	not_entailment
这个故事是特别的。	这段关系是特别的。	not_entailment
这段关系是特别的。	这个故事是特别的。	not_entailment
这种表示是误导的。	这个释义是误导的。	not_entailment
这个释义是误导的。	这种表示是误导的。	not_entailment
这名医生是快乐的。	这个女孩是快乐的。	not_entailment
这个女孩是快乐的。	这名医生是快乐的。	not_entailment
这种病是特别的。	这个发现是特别的。	not_entailment
这个发现是特别的。	这种病是特别的。	not_entailment
这个故事是古怪的。	这个角是古怪的。	not_entailment
这个角是古怪的。	这个故事是古怪的。	not_entailment
这个男人是聪明的。	这部电影是聪明的。	not_entailment
这部电影是聪明的。	这个男人是聪明的。	not_entailment
这个指向是个人的。	这个铃声是个人的。	not_entailment
这个铃声是个人的。	这个指向是个人的。	not_entailment
这次结尾是凄凉的。	这个趋势是凄凉的。	not_entailment
这个趋势是凄凉的。	这次结尾是凄凉的。	not_entailment
这种干酪是美味的。	这个苹果是美味的。	not_entailment
这个苹果是美味的。	这种干酪是美味的。	not_entailment
这次意图是重要的。	越南是重要的。	not_entailment
越南是重要的。	这次意图是重要的。	not_entailment
这次发现是特别的。	这个结合体是特别的。	not_entailment
这个结合体是特别的。	这次发现是特别的。	not_entailment
这个小孩是愚蠢的。	这个问题是愚蠢的。	not_entailment
这个问题是愚蠢的。	这个小孩是愚蠢的。	not_entailment
这个家庭是快乐的。	这片树林是快乐的。	not_entailment
这片树林是快乐的。	这个家庭是快乐的。	not_entailment
这个过程是成熟的。	这个问题是成熟的。	not_entailment
这个问题是成熟的。	这个过程是成熟的。	not_entailment
吉米一家是愤怒的。	世界是愤怒的。	not_entailment
世界是愤怒的。	吉米一家是愤怒的。	not_entailment
这次接住是容易的。	这个方程式是容易的。	not_entailment
这个方程式是容易的。	这次接住是容易的。	not_entailment
这次治疗是特别的。	这个十一月是特别的。	not_entailment
这个十一月是特别的。	这次治疗是特别的。	not_entailment
这部电影是悲伤的。	这个语气是悲伤的。	not_entailment
这个语气是悲伤的。	这部电影是悲伤的。	not_entailment
这个农场是安静的。	这个澳大利亚人是安静的。	not_entailment
这个澳大利亚人是安静的。	这个农场是安静的。	not_entailment
这种水果是少见的。	这种景象是少见的。	not_entailment
这种景象是少见的。	这种水果是少见的。	not_entailment
这次安排是古怪的。	这个世界是古怪的。	not_entailment
这个世界是古怪的。	这次安排是古怪的。	not_entailment
这个远景是遥远的。	牙买加是遥远的。	not_entailment
牙买加是遥远的。	这个远景是遥远的。	not_entailment
这个敌人是遥远的。	这个行星是遥远的。	not_entailment
这个行星是遥远的。	这个敌人是遥远的。	not_entailment
这个实况报道是个人的。	这段经历是个人的。	not_entailment
这段经历是个人的。	这个实况报道是个人的。	not_entailment
这个陶器是迷人的。	这个结合体是迷人的。	not_entailment
这个结合体是迷人的。	这个陶器是迷人的。	not_entailment
这光线是暗淡的。	这间剧院是暗淡的。	not_entailment
这间剧院是暗淡的。	这光线是暗淡的。	not_entailment
这个目标是容易的。	这个主意是容易的。	not_entailment
这个主意是容易的。	这个目标是容易的。	not_entailment
这群人是消瘦的。	这个陶俑是消瘦的。	not_entailment
这个陶俑是消瘦的。	这群人是消瘦的。	not_entailment
这杯啤酒是寒冷的。	这个葡萄牙人是寒冷的。	not_entailment
这个葡萄牙人是寒冷的。	这杯啤酒是寒冷的。	not_entailment
这另外的是惊人的。	这质量是惊人的。	not_entailment
这质量是惊人的。	这另外的是惊人的。	not_entailment
这片树林是宽敞的。	哥伦比亚是宽敞的。	not_entailment
哥伦比亚是宽敞的。	这片树林是宽敞的。	not_entailment
这片树林是美丽的。	这名公主是美丽的。	not_entailment
这名公主是美丽的。	这片树林是美丽的。	not_entailment
这块土砖是潮湿的。	这间酒吧是潮湿的。	not_entailment
这间酒吧是潮湿的。	这块土砖是潮湿的。	not_entailment
这次奥林匹克大会是失望的。	这名消费者是失望的。	not_entailment
这名消费者是失望的。	这次奥林匹克大会是失望的。	not_entailment
这个关系是成熟的。	这个水果是成熟的。	not_entailment
这个水果是成熟的。	这个关系是成熟的。	not_entailment
这个团队是能干的。	这个穆斯林是能干燥的。	not_entailment
这个穆斯林是能干燥的。	这个团队是能干的。	not_entailment
这个体裁是成熟的。	李四是成熟的。	not_entailment
李四是成熟的。	这个体裁是成熟的。	not_entailment
这个社区是不幸的。	这个家庭是不幸的。	not_entailment
这个家庭是不幸的。	这个社区是不幸的。	not_entailment
这个沙滩是潮湿的。	这件内衣是潮湿的。	not_entailment
这件内衣是潮湿的。	这个沙滩是潮湿的。	not_entailment
这个地毯是干净的。	这个地板是干净的。	not_entailment
这个地板是干净的。	这个地毯是干净的。	not_entailment
这种表示是少见的。	这种结合体是少见的。	not_entailment
这种结合体是少见的。	这种表示是少见的。	not_entailment
这个森林是恐怖的。	这未来是恐怖的。	not_entailment
这未来是恐怖的。	这个森林是恐怖的。	not_entailment
这部视频是误导的。	这个陈述是误导的。	not_entailment
这个陈述是误导的。	这部视频是误导的。	not_entailment
这种糖果是美味的。	这种调味汁是美味的。	not_entailment
这种调味汁是美味的。	这种糖果是美味的。	not_entailment
这现实是糟糕的。	这未来是糟糕的。	not_entailment
这未来是糟糕的。	这现实是糟糕的。	not_entailment
这个东西是混乱的。	这工业是混乱的。	not_entailment
这工业是混乱的。	这个东西是混乱的。	not_entailment
这个过程是宝贵的。	这所有物是宝贵的。	not_entailment
这所有物是宝贵的。	这个过程是宝贵的。	not_entailment
这种用法是合适的。	这首歌曲是合适的。	not_entailment
这首歌曲是合适的。	这种用法是合适的。	not_entailment
这个灵魂是疲倦的。	这个病人是疲倦的。	not_entailment
这个病人是疲倦的。	这个灵魂是疲倦的。	not_entailment
这间酒店是怪异的。	悉尼是怪异的。	not_entailment
悉尼是怪异的。	这间酒店是怪异的。	not_entailment
这金融模式是高效的。	这个机器是高效的。	not_entailment
这个机器是高效的。	这金融模式是高效的。	not_entailment
这天是凄凉的。	这个情节是凄凉的。	not_entailment
这个情节是凄凉的。	这天是凄凉的。	not_entailment
这只芦苇是干枯的。	这块皮肤是干枯的。	not_entailment
这块皮肤是干枯的。	这只芦苇是干枯的。	not_entailment
这个味道是糟糕的。	这质量是糟糕的。	not_entailment
这质量是糟糕的。	这个味道是糟糕的。	not_entailment
这个描述是误导的。	这张招贴画是误导的。	not_entailment
这张招贴画是误导的。	这个描述是误导的。	not_entailment
这次旅行是困难的。	这个四月是困难的。	not_entailment
这个四月是困难的。	这次旅行是困难的。	not_entailment
这段对话是滑稽的。	这个卡通是滑稽的。	not_entailment
这个卡通是滑稽的。	这段对话是滑稽的。	not_entailment
这另外的是昂贵的。	这间别墅是昂贵的。	not_entailment
这间别墅是昂贵的。	这另外的是昂贵的。	not_entailment
这个球是潮湿的。	这个二月是潮湿的。	not_entailment
这个二月是潮湿的。	这个球是潮湿的。	not_entailment
亚历山大是能干的。	这个小孩是能干的。	not_entailment
这个小孩是能干的。	亚历山大是能干的。	not_entailment
这瓶果汁是香甜的。	这瓶香水是香甜的。	not_entailment
这瓶香水是香甜的。	这瓶果汁是香甜的。	not_entailment
这数据是巨大的。	这停车场是巨大的。	not_entailment
这停车场是巨大的。	这数据是巨大的。	not_entailment
这个陶器是特别的。	这篇参考文献是特别的。	not_entailment
这篇参考文献是特别的。	这个陶器是特别的。	not_entailment
这家人是饥饿的。	这头狮是饥饿的。	not_entailment
这头狮是饥饿的。	这家人是饥饿的。	not_entailment
这个珠宝是美丽的。	密西西比是美丽的。	not_entailment
密西西比是美丽的。	这个珠宝是美丽的。	not_entailment
这商业是有趣的。	这数学是有趣的。	not_entailment
这数学是有趣的。	这商业是有趣的。	not_entailment
这个苹果是美味的。	这碟菜是美味的。	not_entailment
这碟菜是美味的。	这个苹果是美味的。	not_entailment
这本小说是怪异的。	这个情人节是怪异的。	not_entailment
这个情人节是怪异的。	这本小说是怪异的。	not_entailment
这杯咖啡是不错的。	这个见解是不错的。	not_entailment
这个见解是不错的。	这杯咖啡是不错的。	not_entailment
这个早晨是潮湿的。	这个面包是潮湿的。	not_entailment
这个面包是潮湿的。	这个早晨是潮湿的。	not_entailment
这段历史是古老的。	哥伦布是古老的。	not_entailment
哥伦布是古老的。	这段历史是古老的。	not_entailment
这段历史是有趣的。	这万圣节前夕是有趣的。	not_entailment
这万圣节前夕是有趣的。	这段历史是有趣的。	not_entailment
这部电影是暴力的。	这次屠杀是暴力的。	not_entailment
这次屠杀是暴力的。	这部电影是暴力的。	not_entailment
这个房屋是暗淡的。	这个房间是暗淡的。	not_entailment
这个房间是暗淡的。	这个房屋是暗淡的。	not_entailment
这首歌曲是恐怖的。	这次旅途是恐怖的。	not_entailment
这次旅途是恐怖的。	这首歌曲是恐怖的。	not_entailment
这个酒吧是拥挤的。	这个办公室是拥挤的。	not_entailment
这个办公室是拥挤的。	这个酒吧是拥挤的。	not_entailment
吉米一家是迅速的。	这次行动是迅速的。	not_entailment
这次行动是迅速的。	吉米一家是迅速的。	not_entailment
这个位置是漂亮的。	这间别墅是漂亮的。	not_entailment
这间别墅是漂亮的。	这个位置是漂亮的。	not_entailment
这个山谷是潮湿的。	这间房间是潮湿的。	not_entailment
这间房间是潮湿的。	这个山谷是潮湿的。	not_entailment
这座公园是怪异的。	这个房屋是怪异的。	not_entailment
这个房屋是怪异的。	这座公园是怪异的。	not_entailment
这个行星是寒冷的。	这瓶牛奶是寒冷的。	not_entailment
这瓶牛奶是寒冷的。	这个行星是寒冷的。	not_entailment
这个浴室是干净的。	这滩血是干净的。	not_entailment
这滩血是干净的。	这个浴室是干净的。	not_entailment
这个记录是干净的。	这件内衣是干净的。	not_entailment
这件内衣是干净的。	这个记录是干净的。	not_entailment
这种感觉是特别的。	这种见解是特别的。	not_entailment
这种见解是特别的。	这种感觉是特别的。	not_entailment
这种差别是罕见的。	这种情况是罕见的。	not_entailment
这种情况是罕见的。	这种差别是罕见的。	not_entailment
这片沼泽是潮湿的。	这片土壤是潮湿的。	not_entailment
这片土壤是潮湿的。	这片沼泽是潮湿的。	not_entailment
这个厨房是干净的。	这只芦苇是干净的。	not_entailment
这只芦苇是干净的。	这个厨房是干净的。	not_entailment
这个真相是肮脏的。	这钱是肮脏的。	not_entailment
这钱是肮脏的。	这个真相是肮脏的。	not_entailment
这个问题是成熟的。	这个班级是成熟的。	not_entailment
这个班级是成熟的。	这个问题是成熟的。	not_entailment
这种味道是美味的。	这个单词是美味的。	not_entailment
这个单词是美味的。	这种味道是美味的。	not_entailment
这段时间是短暂的。	这个情人节是短暂的。	not_entailment
这个情人节是短暂的。	这段时间是短暂的。	not_entailment
这将来是有趣的。	这个英国人是有趣的。	not_entailment
这个英国人是有趣的。	这将来是有趣的。	not_entailment
这名记者是生气的。	这个非洲人是生气的。	not_entailment
这个非洲人是生气的。	这名记者是生气的。	not_entailment
这个取景器是宝贵的。	这次休息是宝贵的。	not_entailment
这次休息是宝贵的。	这个取景器是宝贵的。	not_entailment
这本书是恐怖的。	这个标题是恐怖的。	not_entailment
这个标题是恐怖的。	这本书是恐怖的。	not_entailment
这名君主是明智的。	这个乌克兰人是明智的。	not_entailment
这个乌克兰人是明智的。	这名君主是明智的。	not_entailment
这最低限度是巨大的。	这个数字是巨大的。	not_entailment
这个数字是巨大的。	这最低限度是巨大的。	not_entailment
这次修理是容易的。	这次选择是容易的。	not_entailment
这次选择是容易的。	这次修理是容易的。	not_entailment
这个选择是宝贵的。	这次机会是宝贵的。	not_entailment
这次机会是宝贵的。	这个选择是宝贵的。	not_entailment
这个时钟是古怪的。	这个开始是古怪的。	not_entailment
这个开始是古怪的。	这个时钟是古怪的。	not_entailment
这道数学题是困难的。	这篇文章是困难的。	not_entailment
这篇文章是困难的。	这道数学题是困难的。	not_entailment
这个结论是有趣的。	这个情况是有趣的。	not_entailment
这个情况是有趣的。	这个结论是有趣的。	not_entailment
这个顺序是古怪的。	这个数字是古怪的。	not_entailment
这个数字是古怪的。	这个顺序是古怪的。	not_entailment
这只猫是生气的。	这个澳大利亚人是生气的。	not_entailment
这个澳大利亚人是生气的。	这只猫是生气的。	not_entailment
这个结论是暴力的。	吉米一家是暴力的。	not_entailment
吉米一家是暴力的。	这个结论是暴力的。	not_entailment
这款产品是昂贵的。	这个床上用品是昂贵的。	not_entailment
这个床上用品是昂贵的。	这款产品是昂贵的。	not_entailment
这种程序错误是少见的。	这种基因是少见的。	not_entailment
这种基因是少见的。	这种程序错误是少见的。	not_entailment
这个真相是残酷的。	这个邻居是残酷的。	not_entailment
这个邻居是残酷的。	这个真相是残酷的。	not_entailment
这个空间是拥挤的。	这间餐馆是拥挤的。	not_entailment
这间餐馆是拥挤的。	这个空间是拥挤的。	not_entailment
这经济是成熟的。	这项法律是成熟的。	not_entailment
这项法律是成熟的。	这经济是成熟的。	not_entailment
这次处理是快速的。	这次处决是快速的。	not_entailment
这次处决是快速的。	这次处理是快速的。	not_entailment
这个方法是聪明的。	这个计划是聪明的。	not_entailment
这个计划是聪明的。	这个方法是聪明的。	not_entailment
这个场景是暴力的。	这个邻居是暴力的。	not_entailment
这个邻居是暴力的。	这个场景是暴力的。	not_entailment
这杯咖啡是苦涩的。	这场戏是苦涩的。	not_entailment
这场戏是苦涩的。	这杯咖啡是苦涩的。	not_entailment
这间演播室是拥挤的。	这个酒吧是拥挤的。	not_entailment
这个酒吧是拥挤的。	这间演播室是拥挤的。	not_entailment
这种药物是昂贵的。	这本书是昂贵的。	not_entailment
这本书是昂贵的。	这种药物是昂贵的。	not_entailment
这个帮派是暴力的。	这个结尾是暴力的。	not_entailment
这个结尾是暴力的。	这个帮派是暴力的。	not_entailment
这条路是危险的。	这气候是危险的。	not_entailment
这气候是危险的。	这条路是危险的。	not_entailment
这个真相是惊人的。	这个解决方案是惊人的。	not_entailment
这个解决方案是惊人的。	这个真相是惊人的。	not_entailment
这比率是古怪的。	这个十一月是古怪的。	not_entailment
这个十一月是古怪的。	这比率是古怪的。	not_entailment
这个旅行者是疲倦的。	这个澳大利亚人是疲倦的。	not_entailment
这个澳大利亚人是疲倦的。	这个旅行者是疲倦的。	not_entailment
这个诊断是少见的。	这种形状是少见的。	not_entailment
这种形状是少见的。	这个诊断是少见的。	not_entailment
这个公司是高效的。	这个做法是高效的。	not_entailment
这个做法是高效的。	这个公司是高效的。	not_entailment
这种幽默是凄凉的。	这个结尾是凄凉的。	not_entailment
这个结尾是凄凉的。	这种幽默是凄凉的。	not_entailment
吉米一家是古怪的。	这种语气是古怪的。	not_entailment
这种语气是古怪的。	吉米一家是古怪的。	not_entailment
这种算法是容易的。	这个问题是容易的。	not_entailment
这个问题是容易的。	这种算法是容易的。	not_entailment
这个位置是肮脏的。	这个世界是肮脏的。	not_entailment
这个世界是肮脏的。	这个位置是肮脏的。	not_entailment
以太网是高效的。	这种电池是高效的。	not_entailment
这种电池是高效的。	以太网是高效的。	not_entailment
这条金属丝是纤细的。	这根草是纤细的。	not_entailment
这根草是纤细的。	这条金属丝是纤细的。	not_entailment
这个城市是富裕的。	这个英国人是富裕的。	not_entailment
这个英国人是富裕的。	这个城市是富裕的。	not_entailment
这生活是困难的。	这奋斗是困难的。	not_entailment
这奋斗是困难的。	这生活是困难的。	not_entailment
这片地毯是肮脏的。	亚马逊是肮脏的。	not_entailment
亚马逊是肮脏的。	这片地毯是肮脏的。	not_entailment
这不同种类是美味的。	这种糖果是美味的。	not_entailment
这种糖果是美味的。	这不同种类是美味的。	not_entailment
这数学发展是快速的。	这次移动是快速的。	not_entailment
这次移动是快速的。	这数学发展是快速的。	not_entailment
这次定时是明智的。	这个读者是明智的。	not_entailment
这个读者是明智的。	这次定时是明智的。	not_entailment
这只鸟是美味的。	这块肉是美味的。	not_entailment
这块肉是美味的。	这只鸟是美味的。	not_entailment
这气候是糟糕的。	这人际关系是坏的。	not_entailment
这人际关系是坏的。	这气候是糟糕的。	not_entailment
这个角是古怪的。	这个场景是古怪的。	not_entailment
这个场景是古怪的。	这个角是古怪的。	not_entailment
这条连衣裙是漂亮的。	这个位置是漂亮的。	not_entailment
这个位置是漂亮的。	这条连衣裙是漂亮的。	not_entailment
这间花店是重要的。	亚历山大是重要的。	not_entailment
亚历山大是重要的。	这间花店是重要的。	not_entailment
这次离去是困难的。	这次存活是困难的。	not_entailment
这次存活是困难的。	这次离去是困难的。	not_entailment
这条公路是拥挤的。	这个机场是拥挤的。	not_entailment
这个机场是拥挤的。	这条公路是拥挤的。	not_entailment
这片大海是遥远的。	牙买加是遥远的。	not_entailment
牙买加是遥远的。	这片大海是遥远的。	not_entailment
这个信息是个人的。	这个原因是个人的。	not_entailment
这个原因是个人的。	这个信息是个人的。	not_entailment
这个公司是个人的。	这篇参考文献是个人的。	not_entailment
这篇参考文献是个人的。	这个公司是个人的。	not_entailment
这个形状是特别的。	这另外的是特别的。	not_entailment
这另外的是特别的。	这个形状是特别的。	not_entailment
这片土壤是干燥的。	这床被子是干燥的。	not_entailment
这床被子是干燥的。	这片土壤是干燥的。	not_entailment
这里面的是丑陋的。	这套制服是丑陋的。	not_entailment
这套制服是丑陋的。	这里面的是丑陋的。	not_entailment
这个价格是糟糕的。	这个情况是糟糕的。	not_entailment
这个情况是糟糕的。	这个价格是糟糕的。	not_entailment
这条路是拥挤的。	这个竞技场是拥挤的。	not_entailment
这个竞技场是拥挤的。	这条路是拥挤的。	not_entailment
这个结局是暴力的。	这本小说是暴力的。	not_entailment
这本小说是暴力的。	这个结局是暴力的。	not_entailment
这面镜子是肮脏的。	这个厨房是肮脏的。	not_entailment
这个厨房是肮脏的。	这面镜子是肮脏的。	not_entailment
这个景色是漂亮的。	这个出口是漂亮的。	not_entailment
这个出口是漂亮的。	这个景色是漂亮的。	not_entailment
这种关系是特别的。	密歇根是特别的。	not_entailment
密歇根是特别的。	这种关系是特别的。	not_entailment
这空气是干燥的。	这批木材是干燥的。	not_entailment
这批木材是干燥的。	这空气是干燥的。	not_entailment
这间别墅是丑陋的。	乔治亚是丑陋的。	not_entailment
乔治亚是丑陋的。	这间别墅是丑陋的。	not_entailment
这未来是古怪的。	这个希腊人是古怪的。	not_entailment
这个希腊人是古怪的。	这未来是古怪的。	not_entailment
这个中间的人是肥胖的。	这个肝脏是肥胖的。	not_entailment
这个肝脏是肥胖的。	这个中间的人是肥胖的。	not_entailment
这种语气是古怪的。	这个闹钟是古怪的。	not_entailment
这个闹钟是古怪的。	这种语气是古怪的。	not_entailment
这个排挡是昂贵的。	英国是昂贵的。	not_entailment
英国是昂贵的。	这个排挡是昂贵的。	not_entailment
这次移动是明智的。	这位市长是明智的。	not_entailment
这位市长是明智的。	这次移动是明智的。	not_entailment
这间别墅是宝贵的。	这个研究是宝贵的。	not_entailment
这个研究是宝贵的。	这间别墅是宝贵的。	not_entailment
这种条件是少见的。	这个学期是少见的。	not_entailment
这个学期是少见的。	这种条件是少见的。	not_entailment
马丁是聪明的。	这个魔王是聪明的。	not_entailment
这个魔王是聪明的。	马丁是聪明的。	not_entailment
这个食物是美味的。	这张菜单是美味的。	not_entailment
这张菜单是美味的。	这个食物是美味的。	not_entailment
这神谕是著名的。	东京是著名的。	not_entailment
东京是著名的。	这神谕是著名的。	not_entailment
这个结局是悲伤的。	这首音乐是悲伤的。	not_entailment
这首音乐是悲伤的。	这个结局是悲伤的。	not_entailment
这个课题是个人的。	这段经历是个人的。	not_entailment
这段经历是个人的。	这个课题是个人的。	not_entailment
这具身体是疲倦的。	这只狮子是疲倦的。	not_entailment
这只狮子是疲倦的。	这具身体是疲倦的。	not_entailment
这神谕是无效的。	这个论点是无效的。	not_entailment
这个论点是无效的。	这神谕是无效的。	not_entailment
这个男子是疯狂的。	亚历山大是疯狂的。	not_entailment
亚历山大是疯狂的。	这个男子是疯狂的。	not_entailment
这个事情是疯狂的。	这个美国人是疯狂的。	not_entailment
这个美国人是疯狂的。	这个事情是疯狂的。	not_entailment
这块斜纹棉布是巨大的。	这块天花板是巨大的。	not_entailment
这块天花板是巨大的。	这块斜纹棉布是巨大的。	not_entailment
这套装扮是怪异的。	这部电影是怪异的。	not_entailment
这部电影是怪异的。	这套装扮是怪异的。	not_entailment
这块皮革是潮湿的。	这个石是潮湿的。	not_entailment
这个石是潮湿的。	这块皮革是潮湿的。	not_entailment
这位市长是能干的。	史密斯一家是能干的。	not_entailment
史密斯一家是能干的。	这位市长是能干的。	not_entailment
这个游戏是暴力的。	这个开始是暴力的。	not_entailment
这个开始是暴力的。	这个游戏是暴力的。	not_entailment
这个青年是愚蠢的。	这个问题是愚蠢的。	not_entailment
这个问题是愚蠢的。	这个青年是愚蠢的。	not_entailment
这位君主是美丽的。	这片树林是美丽的。	not_entailment
这片树林是美丽的。	这位君主是美丽的。	not_entailment
这只鲨鱼是饥饿的。	这名顾客是饥饿的。	not_entailment
这名顾客是饥饿的。	这只鲨鱼是饥饿的。	not_entailment
这次圣诞节是邻近的。	越南是邻近的。	not_entailment
越南是邻近的。	这次圣诞节是邻近的。	not_entailment
这个联盟是虚弱的。	月球是虚弱的。	not_entailment
月球是虚弱的。	这个联盟是虚弱的。	not_entailment
这张地毯是干燥的。	这空气是干燥的。	not_entailment
这空气是干燥的。	这张地毯是干燥的。	not_entailment
这块肉是美味的。	这个餐馆是美味的。	not_entailment
这个餐馆是美味的。	这块肉是美味的。	not_entailment
这次转型是必需的。	这个大学生是必需的。	not_entailment
这个大学生是必需的。	这次转型是必需的。	not_entailment
这块冰是透明的。	这块玻璃是透明的。	not_entailment
这块玻璃是透明的。	这块冰是透明的。	not_entailment
这经济是糟糕的。	这现实是糟糕的。	not_entailment
这现实是糟糕的。	这经济是糟糕的。	not_entailment
这个商场是拥挤的。	这条大街是拥挤的。	not_entailment
这条大街是拥挤的。	这个商场是拥挤的。	not_entailment
这块地是潮湿的。	这块玻璃是潮湿的。	not_entailment
这块玻璃是潮湿的。	这块地是潮湿的。	not_entailment
这片树林是宝贵的。	这片芦苇是宝贵的。	not_entailment
这片芦苇是宝贵的。	这片树林是宝贵的。	not_entailment
这个厨师是能干的。	这个墨西哥人是能干的。	not_entailment
这个墨西哥人是能干的。	这个厨师是能干的。	not_entailment
这个问题是糟糕的。	这个后果是糟糕的。	not_entailment
这个后果是糟糕的。	这个问题是糟糕的。	not_entailment
这名首领是失望的。	这次奥林匹克大会是失望的。	not_entailment
这次奥林匹克大会是失望的。	这名首领是失望的。	not_entailment
这段休息时间是个人的。	这段经验是个人的。	not_entailment
这段经验是个人的。	这段休息时间是个人的。	not_entailment
这种电池是高效的。	这个加工机是高效的。	not_entailment
这个加工机是高效的。	这种电池是高效的。	not_entailment
这个希腊人是古怪的。	这种语气是古怪的。	not_entailment
这种语气是古怪的。	这个希腊人是古怪的。	not_entailment
这部戏剧是暴力的。	这个二月是暴力的。	not_entailment
这个二月是暴力的。	这部戏剧是暴力的。	not_entailment
这位公爵是肥胖的。	这只猫是肥胖的。	not_entailment
这只猫是肥胖的。	这位公爵是肥胖的。	not_entailment
这个想法是糟糕的。	这次降温是糟糕的。	not_entailment
这次降温是糟糕的。	这个想法是糟糕的。	not_entailment
这个DVD是危险的。	这气候是危险的。	not_entailment
这气候是危险的。	这个DVD是危险的。	not_entailment
这个顾客是烦人的。	这段噪音是烦人的。	not_entailment
这段噪音是烦人的。	这个顾客是烦人的。	not_entailment
这个DVD是滑稽的。	这个想法是滑稽的。	not_entailment
这个想法是滑稽的。	这个DVD是滑稽的。	not_entailment
这些人是饥饿的。	这只猫是饥饿的。	not_entailment
这只猫是饥饿的。	这些人是饥饿的。	not_entailment
这间别墅是美好的。	这间浴室是美好的。	not_entailment
这间浴室是美好的。	这间别墅是美好的。	not_entailment
这个混合物是古怪的。	这个名称是古怪的。	not_entailment
这个名称是古怪的。	这个混合物是古怪的。	not_entailment
这块混凝土是潮湿的。	这块墨水是潮湿的。	not_entailment
这块墨水是潮湿的。	这块混凝土是潮湿的。	not_entailment
这个珠宝是重要的。	这个环境是重要的。	not_entailment
这个环境是重要的。	这个珠宝是重要的。	not_entailment
这个主意是烦人的。	这些昆虫是烦人的。	not_entailment
这些昆虫是烦人的。	这个主意是烦人的。	not_entailment
马丁是肥胖的。	这只狮子是肥胖的。	not_entailment
这只狮子是肥胖的。	马丁是肥胖的。	not_entailment
这段关系是个人的。	这神谕是个人的。	not_entailment
这神谕是个人的。	这段关系是个人的。	not_entailment
这次聚会是热闹的。	这段跳舞是热闹的。	not_entailment
这段跳舞是热闹的。	这次聚会是热闹的。	not_entailment
这前者是特别的。	这片树林是特别的。	not_entailment
这片树林是特别的。	这前者是特别的。	not_entailment
这个小孩是疯狂的。	这个温哥华人是疯狂的。	not_entailment
这个温哥华人是疯狂的。	这个小孩是疯狂的。	not_entailment
这个顾客是聪明的。	这个穆斯林是聪明的。	not_entailment
这个穆斯林是聪明的。	这个顾客是聪明的。	not_entailment
这个戏剧是滑稽的。	这个说辞是滑稽的。	not_entailment
这个说辞是滑稽的。	这个戏剧是滑稽的。	not_entailment
这个点心是美味的。	这个水果是美味的。	not_entailment
这个水果是美味的。	这个点心是美味的。	not_entailment
这个流水线是高效的。	这个机械装置是高效的。	not_entailment
这个机械装置是高效的。	这个流水线是高效的。	not_entailment
这个镇子是热闹的。	这个剧院是热闹的。	not_entailment
这个剧院是热闹的。	这个镇子是热闹的。	not_entailment
布兰妮是悲伤的。	这种情绪是悲伤的。	not_entailment
这种情绪是悲伤的。	布兰妮是悲伤的。	not_entailment
这次奥林匹克大会是疲倦的。	这头狮子是疲倦的。	not_entailment
这头狮子是疲倦的。	这次奥林匹克大会是疲倦的。	not_entailment
这个状态是担心的。	这工业是担心的。	not_entailment
这工业是担心的。	这个状态是担心的。	not_entailment
汤普森是积极的。	这个结果是积极的。	not_entailment
这个结果是积极的。	汤普森是积极的。	not_entailment
这个结果是重要的。	这个开始是重要的。	not_entailment
这个开始是重要的。	这个结果是重要的。	not_entailment
这种植物是少见的。	这种德国人是少见的。	not_entailment
这种德国人是少见的。	这种植物是少见的。	not_entailment
这个购物者是优美的。	加勒比海是优美的。	not_entailment
加勒比海是优美的。	这个购物者是优美的。	not_entailment
这块肉是肥胖的。	这个肝脏是肥胖的。	not_entailment
这个肝脏是肥胖的。	这块肉是肥胖的。	not_entailment
这另外是必需的。	这个过程是必需的。	not_entailment
这个过程是必需的。	这另外是必需的。	not_entailment
这首音乐是糟糕的。	这部电影是糟糕的。	not_entailment
这部电影是糟糕的。	这首音乐是糟糕的。	not_entailment
这夜晚是热闹的。	这个集市是热闹的。	not_entailment
这个集市是热闹的。	这夜晚是热闹的。	not_entailment
这内部是丑陋的。	这个过程是丑陋的。	not_entailment
这个过程是丑陋的。	这内部是丑陋的。	not_entailment
这瓶葡萄酒瓶是干燥的。	这个床上用品是干燥的。	not_entailment
这个床上用品是干燥的。	这瓶葡萄酒瓶是干燥的。	not_entailment
这匹马是可爱的。	这个邻居是可爱的。	not_entailment
这个邻居是可爱的。	这匹马是可爱的。	not_entailment
这首说唱是悲伤的。	这个结局是悲伤的。	not_entailment
这个结局是悲伤的。	这首说唱是悲伤的。	not_entailment
这给结合体是特别的。	这另外的是特别的。	not_entailment
这另外的是特别的。	这给结合体是特别的。	not_entailment
这部戏剧是恐怖的。	这个计划是恐怖的。	not_entailment
这个计划是恐怖的。	这部戏剧是恐怖的。	not_entailment
这过去是丑陋的。	这个场景是丑陋的。	not_entailment
这个场景是丑陋的。	这过去是丑陋的。	not_entailment
这个机器人是可爱的。	这个邻居是可爱的。	not_entailment
这个邻居是可爱的。	这个机器人是可爱的。	not_entailment
这条路线是容易的。	这个设置是容易的。	not_entailment
这个设置是容易的。	这条路线是容易的。	not_entailment
这摄像机是真实的。	这真相是真实的。	not_entailment
这真相是真实的。	这摄像机是真实的。	not_entailment
这种情绪是悲伤的。	这个想法是悲伤的。	not_entailment
这个想法是悲伤的。	这种情绪是悲伤的。	not_entailment
这个论点是片面的。	这个视角是片面的。	not_entailment
这个视角是片面的。	这个论点是片面的。	not_entailment
这个阴影是怪异的。	这部电影是怪异的。	not_entailment
这部电影是怪异的。	这个阴影是怪异的。	not_entailment
这个海湾是漂亮的。	这朵花是漂亮的。	not_entailment
这朵花是漂亮的。	这个海湾是漂亮的。	not_entailment
这杯茶叶是滚烫的。	这碗调味汁是滚烫的。	not_entailment
这碗调味汁是滚烫的。	这杯茶叶是滚烫的。	not_entailment
这个陶器是困难的。	这个摄像机是困难的。	not_entailment
这个摄像机是困难的。	这个陶器是困难的。	not_entailment
这个速度是疯狂的。	这个位置是疯狂的。	not_entailment
这个位置是疯狂的。	这个速度是疯狂的。	not_entailment
这个游戏是可爱的。	这个产品是可爱的。	not_entailment
这个产品是可爱的。	这个游戏是可爱的。	not_entailment
这种算法是高效的。	这台机器是高效的。	not_entailment
这台机器是高效的。	这种算法是高效的。	not_entailment
这希腊人是糟糕的。	这经济是糟糕的。	not_entailment
这经济是糟糕的。	这希腊人是糟糕的。	not_entailment
这件衬衫是可爱的。	这个印度人是可爱的。	not_entailment
这个印度人是可爱的。	这件衬衫是可爱的。	not_entailment
这位顾客是高效的。	这个作用是高效的。	not_entailment
这个作用是高效的。	这位顾客是高效的。	not_entailment
这个敌人是困难的。	这个任务是困难的。	not_entailment
这个任务是困难的。	这个敌人是困难的。	not_entailment
这只狗是愚蠢的。	珍妮弗是愚蠢的。	not_entailment
珍妮弗是愚蠢的。	这只狗是愚蠢的。	not_entailment
这位公爵是失望的。	这个世界是失望的。	not_entailment
这个世界是失望的。	这位公爵是失望的。	not_entailment
这次纠正是愚蠢的。	这个男人是愚蠢的。	not_entailment
这个男人是愚蠢的。	这次纠正是愚蠢的。	not_entailment
这个卡通是可爱的。	这位邻居是可爱的。	not_entailment
这位邻居是可爱的。	这个卡通是可爱的。	not_entailment
这瓶果汁是美味的。	这种果酱是美味的。	not_entailment
这种果酱是美味的。	这瓶果汁是美味的。	not_entailment
这雪是潮湿的。	佛罗里达州是潮湿的。	not_entailment
佛罗里达州是潮湿的。	这雪是潮湿的。	not_entailment
这磨光机是不停的。	这河流是不停的。	not_entailment
这河流是不停的。	这磨光机是不停的。	not_entailment
这首音乐是合适的。	这个情况是合适的。	not_entailment
这个情况是合适的。	这首音乐是合适的。	not_entailment
这朵花是漂亮的。	这个邻居是漂亮的。	not_entailment
这个邻居是漂亮的。	这朵花是漂亮的。	not_entailment
这种均衡是古怪的。	这个气氛是古怪的。	not_entailment
这个气氛是古怪的。	这种均衡是古怪的。	not_entailment
这个dvd是干净的。	哥伦比亚是干净的。	not_entailment
哥伦比亚是干净的。	这个dvd是干净的。	not_entailment
这个世界是丰富的。	这个领域是丰富的。	not_entailment
这个领域是丰富的。	这个世界是丰富的。	not_entailment
这种做法是少见的。	这种短语是少见的。	not_entailment
这种短语是少见的。	这种做法是少见的。	not_entailment
这乌木是香甜的。	这泰国菜是香甜的。	not_entailment
这泰国菜是香甜的。	这乌木是香甜的。	not_entailment
这个珠宝是著名的。	这个保加利亚人是著名的。	not_entailment
这个保加利亚人是著名的。	这个珠宝是著名的。	not_entailment
这个镇子是安静的。	这个演播室是安静的。	not_entailment
这个演播室是安静的。	这个镇子是安静的。	not_entailment
这政府是担心的。	这个希腊人是担心的。	not_entailment
这个希腊人是担心的。	这政府是担心的。	not_entailment
这个正式建议是积极的。	这俄语是积极的。	not_entailment
这俄语是积极的。	这个正式建议是积极的。	not_entailment
这块玻璃是肮脏的。	这块地毯是肮脏的。	not_entailment
这块地毯是肮脏的。	这块玻璃是肮脏的。	not_entailment
这个村庄是贫穷的。	这些居民是贫穷的。	not_entailment
这些居民是贫穷的。	这个村庄是贫穷的。	not_entailment
这名平民的是失望的。	这个读者是失望的。	not_entailment
这个读者是失望的。	这名平民的是失望的。	not_entailment
这个团队是松散的。	这助行器是松散的。	not_entailment
这助行器是松散的。	这个团队是松散的。	not_entailment
这法律是有力的。	这商业是有力的。	not_entailment
这商业是有力的。	这法律是有力的。	not_entailment
这个广告是误导的。	这个图表是误导的。	not_entailment
这个图表是误导的。	这个广告是误导的。	not_entailment
月球是漂亮的。	这个背景是漂亮的。	not_entailment
这个背景是漂亮的。	月球是漂亮的。	not_entailment
这个房屋是漂亮的。	马丁是漂亮的。	not_entailment
马丁是漂亮的。	这个房屋是漂亮的。	not_entailment
这天气是寒冷的。	这皮肤是寒冷的。	not_entailment
这皮肤是寒冷的。	这天气是寒冷的。	not_entailment
这个实验是有趣的。	这个解决方案是有趣的。	not_entailment
这个解决方案是有趣的。	这个实验是有趣的。	not_entailment
这名杂技演员是聪明的。	这个公爵是聪明的。	not_entailment
这个公爵是聪明的。	这名杂技演员是聪明的。	not_entailment
这个温度是寒冷的。	英国是寒冷的。	not_entailment
英国是寒冷的。	这个温度是寒冷的。	not_entailment
这条路是安静的。	这片树林是安静的。	not_entailment
这片树林是安静的。	这条路是安静的。	not_entailment
这块斜纹棉布是肮脏的。	这块地是肮脏的。	not_entailment
这块地是肮脏的。	这块斜纹棉布是肮脏的。	not_entailment
