premise hypothesis  label
这个集市是诱人的。	这个集市是丰富的。	not_entailment
这个集市是丰富的。	这个集市是诱人的。	not_entailment
这位物主是生气的。	这位物主是高兴的。	not_entailment
这位物主是高兴的。	这位物主是生气的。	not_entailment
史密斯一家是热情的。	史密斯一家是迷糊的。	not_entailment
史密斯一家是迷糊的。	史密斯一家是热情的。	not_entailment
这个混合物是糟糕的。	这个混合物是活泼的。	not_entailment
这个混合物是活泼的。	这个混合物是糟糕的。	not_entailment
这个奖杯是宝贵的。	这个奖杯是铜制的。	not_entailment
这个奖杯是铜制的。	这个奖杯是宝贵的。	not_entailment
这位医生是失望的。	这位医生是疯癫的。	not_entailment
这位医生是疯癫的。	这位医生是失望的。	not_entailment
这个主题是悲伤的。	这个主题是愤怒的。	not_entailment
这个主题是愤怒的。	这个主题是悲伤的。	not_entailment
这个地面是肮脏的。	这个地面是潮湿的。	not_entailment
这个地面是潮湿的。	这个地面是肮脏的。	not_entailment
这天天气是糟糕的。	这天天气是阴沉的。	not_entailment
这天天气是阴沉的。	这天天气是糟糕的。	not_entailment
路易斯一家是积极的。	路易斯一家是活泼的。	not_entailment
路易斯一家是活泼的。	路易斯一家是积极的。	not_entailment
这碗汤是热的。	这碗汤是难喝的。	not_entailment
这碗汤是难喝的。	这碗汤是热的。	not_entailment
这个学说是有趣的。	这个学说是虚假的。	not_entailment
这个学说是虚假的。	这个学说是有趣的。	not_entailment
史密斯一家是重要的。	史密斯一家是阴沉的。	not_entailment
史密斯一家是阴沉的。	史密斯一家是重要的。	not_entailment
这片大海是危险的。	这片大海是干净的。	not_entailment
这片大海是干净的。	这片大海是危险的。	not_entailment
这个蓝牙是好用的。	这个蓝牙是迅速的。	not_entailment
这个蓝牙是迅速的。	这个蓝牙是好用的。	not_entailment
这个人的是能干的。	这个人的是完美的。	not_entailment
这个人的是完美的。	这个人的是能干的。	not_entailment
这篇参考文献是重要的。	这篇参考文献是消极的。	not_entailment
这篇参考文献是消极的。	这篇参考文献是重要的。	not_entailment
这个女孩是迷人的。	这个女孩是黑暗的。	not_entailment
这个女孩是黑暗的。	这个女孩是迷人的。	not_entailment
这首说唱是强劲的。	这首说唱是古怪的。	not_entailment
这首说唱是古怪的。	这首说唱是强劲的。	not_entailment
这次狩猎是疯狂的。	这次狩猎是危险的。	not_entailment
这次狩猎是危险的。	这次狩猎是疯狂的。	not_entailment
这个味道是难闻的。	这个味道是熟悉的。	not_entailment
这个味道是熟悉的。	这个味道是难闻的。	not_entailment
这个洞察力是宝贵的。	这个洞察力是个人的。	not_entailment
这个洞察力是个人的。	这个洞察力是宝贵的。	not_entailment
这个梦是怪异的。	这个梦是迷人的。	not_entailment
这个梦是迷人的。	这个梦是怪异的。	not_entailment
这个时钟是坏掉的。	这个时钟是微型的。	not_entailment
这个时钟是微型的。	这个时钟是坏掉的。	not_entailment
这个真相是糟糕的。	这个真相是惊人的。	not_entailment
这个真相是惊人的。	这个真相是糟糕的。	not_entailment
这个概念是新颖的。	这个概念是糟糕的。	not_entailment
这个概念是糟糕的。	这个概念是新颖的。	not_entailment
这片树林是茂盛的。	这片树林是腐臭的。	not_entailment
这片树林是腐臭的。	这片树林是茂盛的。	not_entailment
这个情况是疯狂的。	这个情况是不错的。	not_entailment
这个情况是不错的。	这个情况是疯狂的。	not_entailment
这片海岸是潮湿的。	这片海岸是热闹的。	not_entailment
这片海岸是热闹的。	这片海岸是潮湿的。	not_entailment
这个结合体是少见的。	这个结合体是可怕的。	not_entailment
这个结合体是可怕的。	这个结合体是少见的。	not_entailment
史密斯一家是能干的。	史密斯一家是悲观的。	not_entailment
史密斯一家是悲观的。	史密斯一家是能干的。	not_entailment
这次对话是不快的。	这次对话是宝贵的。	not_entailment
这次对话是宝贵的。	这次对话是不快的。	not_entailment
这块黏土是潮湿的。	这块黏土是巨大的。	not_entailment
这块黏土是巨大的。	这块黏土是潮湿的。	not_entailment
这块布料是宝贵的。	这块布料是可爱的。	not_entailment
这块布料是可爱的。	这块布料是宝贵的。	not_entailment
这个男孩是聪明的。	这个男孩是讨厌的。	not_entailment
这个男孩是讨厌的。	这个男孩是聪明的。	not_entailment
这位经理是快乐的。	这位经理是少见的。	not_entailment
这位经理是少见的。	这位经理是快乐的。	not_entailment
这种果酱是美味的。	这种果酱是昂贵的。	not_entailment
这种果酱是昂贵的。	这种果酱是美味的。	not_entailment
这夜是安静的。	这夜是漆黑的。	not_entailment
这夜是漆黑的。	这夜是安静的。	not_entailment
这片地区是废弃的。	这片地区是富饶的。	not_entailment
这片地区是富饶的。	这片地区是废弃的。	not_entailment
这首音乐是动听的。	这首音乐是奇怪的。	not_entailment
这首音乐是奇怪的。	这首音乐是动听的。	not_entailment
这锅油是滚烫的。	这锅油是金黄的。	not_entailment
这锅油是金黄的。	这锅油是滚烫的。	not_entailment
这个房间是肮脏的。	这个房间是狭小的。	not_entailment
这个房间是狭小的。	这个房间是肮脏的。	not_entailment
这部电影是暴力的。	这部电影是奇幻的。	not_entailment
这部电影是奇幻的。	这部电影是暴力的。	not_entailment
这个希望是渺茫的。	这个希望是珍贵的。	not_entailment
这个希望是珍贵的。	这个希望是渺茫的。	not_entailment
这个世界是恐怖的。	这个世界是光明的。	not_entailment
这个世界是光明的。	这个世界是恐怖的。	not_entailment
这位贵族是明智的。	这位贵族是少见的。	not_entailment
这位贵族是少见的。	这位贵族是明智的。	not_entailment
这个设计是新颖的。	这个设计是实用的。	not_entailment
这个设计是实用的。	这个设计是新颖的。	not_entailment
这次处理是快速的。	这次处理是不妥的。	not_entailment
这次处理是不妥的。	这次处理是快速的。	not_entailment
这个世界是丑陋的。	这个世界是丰富的。	not_entailment
这个世界是丰富的。	这个世界是丑陋的。	not_entailment
这种解释是容易的。	这种解释是无聊的。	not_entailment
这种解释是无聊的。	这种解释是容易的。	not_entailment
这片树林是宽阔的。	这片树林是幽深的。	not_entailment
这片树林是幽深的。	这片树林是宽阔的。	not_entailment
当下是积极的。	当下是完美的。	not_entailment
当下是完美的。	当下是积极的。	not_entailment
强尼一家是危险的。	强尼一家是和蔼的。	not_entailment
强尼一家是和蔼的。	强尼一家是危险的。	not_entailment
这首音乐是和谐的。	这首音乐是绝望的。	not_entailment
这首音乐是绝望的。	这首音乐是和谐的。	not_entailment
这位富豪是奢靡的。	这位富豪是可憎的。	not_entailment
这位富豪是可憎的。	这位富豪是奢靡的。	not_entailment
这个差别是烦人的。	这个差别是迷人的。	not_entailment
这个差别是迷人的。	这个差别是烦人的。	not_entailment
这对夫妇是快乐的。	这对夫妇是激动的。	not_entailment
这对夫妇是激动的。	这对夫妇是快乐的。	not_entailment
这个世界是潮湿的。	这个世界是灿烂的。	not_entailment
这个世界是灿烂的。	这个世界是潮湿的。	not_entailment
单词是大量的。	单词是生僻的。	not_entailment
单词是生僻的。	单词是大量的。	not_entailment
陶工是担心的。	陶工是快乐的。	not_entailment
陶工是快乐的。	陶工是担心的。	not_entailment
这片海洋是肮脏的。	这片海洋是古老的。	not_entailment
这片海洋是古老的。	这片海洋是肮脏的。	not_entailment
这片沙漠是干燥的。	这片沙漠是无人的。	not_entailment
这片沙漠是无人的。	这片沙漠是干燥的。	not_entailment
这个天花板是雪白的。	这个天花板是木制的。	not_entailment
这个天花板是木制的。	这个天花板是雪白的。	not_entailment
这个故事是恐怖的。	这个故事是绝望的。	not_entailment
这个故事是绝望的。	这个故事是恐怖的。	not_entailment
这个侏儒是明智的。	这个侏儒是杰出的。	not_entailment
这个侏儒是杰出的。	这个侏儒是明智的。	not_entailment
化学是奇妙的。	化学是深奥的。	not_entailment
化学是深奥的。	化学是奇妙的。	not_entailment
这位君主是疲倦的。	这位君主是悲惨的。	not_entailment
这位君主是悲惨的。	这位君主是疲倦的。	not_entailment
这位女王是快乐的。	这位女王是活泼的。	not_entailment
这位女王是活泼的。	这位女王是快乐的。	not_entailment
这个消费者是快乐的。	这个消费者是富有的。	not_entailment
这个消费者是富有的。	这个消费者是快乐的。	not_entailment
这首歌曲是合适的。	这首歌曲是可怕的。	not_entailment
这首歌曲是可怕的。	这首歌曲是合适的。	not_entailment
这条法律是严格的。	这条法律是简单的。	not_entailment
这条法律是简单的。	这条法律是严格的。	not_entailment
这个成年男子是肥胖的。	这个成年男子是凶残的。	not_entailment
这个成年男子是凶残的。	这个成年男子是肥胖的。	not_entailment
这位市长是担心的。	这位市长是暴怒的。	not_entailment
这位市长是暴怒的。	这位市长是担心的。	not_entailment
这个无线电广播是安静的。	这个无线电广播是无聊的。	not_entailment
这个无线电广播是无聊的。	这个无线电广播是安静的。	not_entailment
这些问题是严峻的。	这些问题是简单的。	not_entailment
这些问题是简单的。	这些问题是严峻的。	not_entailment
这个结尾是有趣的。	这个结尾是残酷的。	not_entailment
这个结尾是残酷的。	这个结尾是有趣的。	not_entailment
这个小孩是滑稽的。	这个小孩是沉默的。	not_entailment
这个小孩是沉默的。	这个小孩是滑稽的。	not_entailment
这个问题是普遍的。	这个问题是极好的。	not_entailment
这个问题是极好的。	这个问题是普遍的。	not_entailment
这片雪地是寒冷的。	这片雪地是雪白的。	not_entailment
这片雪地是雪白的。	这片雪地是寒冷的。	not_entailment
这块皮肤是细腻的。	这块皮肤是雪白的。	not_entailment
这块皮肤是雪白的。	这块皮肤是细腻的。	not_entailment
这位经理是生气的。	这位经理是糟糕的。	not_entailment
这位经理是糟糕的。	这位经理是生气的。	not_entailment
这个集市是疯狂的。	这个集市是可怕的。	not_entailment
这个集市是可怕的。	这个集市是疯狂的。	not_entailment
这个语气是合适的。	这个语气是奇怪的。	not_entailment
这个语气是奇怪的。	这个语气是合适的。	not_entailment
这个故事是误导的。	这个故事是幽默的。	not_entailment
这个故事是幽默的。	这个故事是误导的。	not_entailment
史密斯一家是善良的。	史密斯一家是饥饿的。	not_entailment
史密斯一家是饥饿的。	史密斯一家是善良的。	not_entailment
这块脂肪是肥大的。	这块脂肪是美味的。	not_entailment
这块脂肪是美味的。	这块脂肪是肥大的。	not_entailment
这个配方是美味的。	这个配方是稀有的。	not_entailment
这个配方是稀有的。	这个配方是美味的。	not_entailment
这个陶工是快乐的。	这个陶工是可怕的。	not_entailment
这个陶工是可怕的。	这个陶工是快乐的。	not_entailment
现实是残酷的。	现实是乐观的。	not_entailment
现实是乐观的。	现实是残酷的。	not_entailment
这种陶器是大量的。	这种陶器是优美的。	not_entailment
这种陶器是优美的。	这种陶器是大量的。	not_entailment
经济是衰退的。	经济是单一的。	not_entailment
经济是单一的。	经济是衰退的。	not_entailment
这篇文章是怪异的。	这篇文章是活泼的。	not_entailment
这篇文章是活泼的。	这篇文章是怪异的。	not_entailment
这个结果是高效的。	这个结果是私人的。	not_entailment
这个结果是私人的。	这个结果是高效的。	not_entailment
这花店是个人的。	这花店是冷清的。	not_entailment
这花店是冷清的。	这花店是个人的。	not_entailment
这个戒指是宝贵的。	这个戒指是简约的。	not_entailment
这个戒指是简约的。	这个戒指是宝贵的。	not_entailment
这个世界是绚烂的。	这个世界是嘈杂的。	not_entailment
这个世界是嘈杂的。	这个世界是绚烂的。	not_entailment
奋斗是艰苦的。	奋斗是振奋的。	not_entailment
奋斗是振奋的。	奋斗是艰苦的。	not_entailment
这种毒品是危险的。	这种毒品是昂贵的。	not_entailment
这种毒品是昂贵的。	这种毒品是危险的。	not_entailment
教育是必需的。	教育是快乐的。	not_entailment
教育是快乐的。	教育是必需的。	not_entailment
这个条件是特别的。	这个条件是诱人的。	not_entailment
这个条件是诱人的。	这个条件是特别的。	not_entailment
这个态度是合适的。	这个态度是自信的。	not_entailment
这个态度是自信的。	这个态度是合适的。	not_entailment
这个细节是惊人的。	这个细节是微小的。	not_entailment
这个细节是微小的。	这个细节是惊人的。	not_entailment
这个世界是狭小的。	这个世界是迷人的。	not_entailment
这个世界是迷人的。	这个世界是狭小的。	not_entailment
月球是冰冷的。	月球是铁制的。	not_entailment
月球是铁制的。	月球是冰冷的。	not_entailment
这个卡通是可爱的。	这个卡通是潦草的。	not_entailment
这个卡通是潦草的。	这个卡通是可爱的。	not_entailment
吉米一家是附近的。	吉米一家是疯癫的。	not_entailment
吉米一家是疯癫的。	吉米一家是附近的。	not_entailment
这个后果是暴力的。	这个后果是严重的。	not_entailment
这个后果是严重的。	这个后果是暴力的。	not_entailment
这个背景是漂亮的。	这个背景是危险的。	not_entailment
这个背景是危险的。	这个背景是漂亮的。	not_entailment
这条公路是危险的。	这条公路是热闹的。	not_entailment
这条公路是热闹的。	这条公路是危险的。	not_entailment
吉米一家是美好的。	吉米一家是热闹的。	not_entailment
吉米一家是热闹的。	吉米一家是美好的。	not_entailment
这个梦是危险的。	这个梦是愚蠢的。	not_entailment
这个梦是愚蠢的。	这个梦是危险的。	not_entailment
这种病是特别的。	这种病是严重的。	not_entailment
这种病是严重的。	这种病是特别的。	not_entailment
这个喜剧片是凄凉的。	这个喜剧片是罕见的。	not_entailment
这个喜剧片是罕见的。	这个喜剧片是凄凉的。	not_entailment
史密斯一家是快乐的。	史密斯一家是富有的。	not_entailment
史密斯一家是富有的。	史密斯一家是快乐的。	not_entailment
这面镜子是肮脏的。	这面镜子是宽大的。	not_entailment
这面镜子是宽大的。	这面镜子是肮脏的。	not_entailment
这个行为是少见的。	这个行为是基本的。	not_entailment
这个行为是基本的。	这个行为是少见的。	not_entailment
这张床是潮湿的。	这张床是宽阔的。	not_entailment
这张床是宽阔的。	这张床是潮湿的。	not_entailment
吉米一家是和睦的。	吉米一家是活泼的。	not_entailment
吉米一家是活泼的。	吉米一家是和睦的。	not_entailment
这位教师是失望的。	这位教师是轻松的。	not_entailment
这位教师是轻松的。	这位教师是失望的。	not_entailment
这道彩虹是漂亮的。	这道彩虹是无价的。	not_entailment
这道彩虹是无价的。	这道彩虹是漂亮的。	not_entailment
约瑟夫家族是重要的。	约瑟夫家族是古老的。	not_entailment
约瑟夫家族是古老的。	约瑟夫家族是重要的。	not_entailment
这条记录是误导的。	这条记录是整洁的。	not_entailment
这条记录是整洁的。	这条记录是误导的。	not_entailment
这个戏是庞大的。	这个戏是少见的。	not_entailment
这个戏是少见的。	这个戏是庞大的。	not_entailment
这位君主是快乐的。	这位君主是长寿的。	not_entailment
这位君主是长寿的。	这位君主是快乐的。	not_entailment
这个时钟是古怪的。	这个时钟是陈旧的。	not_entailment
这个时钟是陈旧的。	这个时钟是古怪的。	not_entailment
这顿晚餐是美味的。	这顿晚餐是私人的。	not_entailment
这顿晚餐是私人的。	这顿晚餐是美味的。	not_entailment
这次市场营销是聪明的。	这次市场营销是重要的。	not_entailment
这次市场营销是重要的。	这次市场营销是聪明的。	not_entailment
黎明是暗淡的。	黎明是缓慢的。	not_entailment
黎明是缓慢的。	黎明是暗淡的。	not_entailment
这位顾客是快乐的。	这位顾客是沉默的。	not_entailment
这位顾客是沉默的。	这位顾客是快乐的。	not_entailment
这次移动是合适的。	这次移动是拥挤的。	not_entailment
这次移动是拥挤的。	这次移动是合适的。	not_entailment
这个过程是危险的。	这个过程是干净的。	not_entailment
这个过程是干净的。	这个过程是危险的。	not_entailment
这间监狱是拥挤的。	这间监狱是少有的。	not_entailment
这间监狱是少有的。	这间监狱是拥挤的。	not_entailment
这个助行器是滑稽的。	这个助行器是干净的。	not_entailment
这个助行器是干净的。	这个助行器是滑稽的。	not_entailment
这个城市是危险的。	这个城市是忧愁的。	not_entailment
这个城市是忧愁的。	这个城市是危险的。	not_entailment
这个花店是狭窄的。	这个花店是温馨的。	not_entailment
这个花店是温馨的。	这个花店是狭窄的。	not_entailment
路易斯一家是豪华的。	路易斯一家是杰出的。	not_entailment
路易斯一家是杰出的。	路易斯一家是豪华的。	not_entailment
这条公路是拥挤的。	这条公路是完美的。	not_entailment
这条公路是完美的。	这条公路是拥挤的。	not_entailment
这个房间是怪异的。	这个房间是杂乱的。	not_entailment
这个房间是杂乱的。	这个房间是怪异的。	not_entailment
这个面具是丑陋的。	这个面具是潮湿的。	not_entailment
这个面具是潮湿的。	这个面具是丑陋的。	not_entailment
这个地点是潮湿的。	这个地点是邻近的。	not_entailment
这个地点是邻近的。	这个地点是潮湿的。	not_entailment
这片芦苇是宝贵的。	这片芦苇是迷人的。	not_entailment
这片芦苇是迷人的。	这片芦苇是宝贵的。	not_entailment
这个城市是迷人的。	这个城市是喧闹的。	not_entailment
这个城市是喧闹的。	这个城市是迷人的。	not_entailment
这个空间是宝贵的。	这个空间是美好的。	not_entailment
这个空间是美好的。	这个空间是宝贵的。	not_entailment
这片水池是漂亮的。	这片水池是极小的。	not_entailment
这片水池是极小的。	这片水池是漂亮的。	not_entailment
亚历山大是烦人的。	亚历山大是干净的。	not_entailment
亚历山大是干净的。	亚历山大是烦人的。	not_entailment
这项技术是高效的。	这项技术是失败的。	not_entailment
这项技术是失败的。	这项技术是高效的。	not_entailment
这位经理是失望的。	这位经理是活泼的。	not_entailment
这位经理是活泼的。	这位经理是失望的。	not_entailment
互联网是丰富的。	互联网是高效的。	not_entailment
互联网是高效的。	互联网是丰富的。	not_entailment
这个陶器是特别的。	这个陶器是巨大的。	not_entailment
这个陶器是巨大的。	这个陶器是特别的。	not_entailment
这个原因是特别的。	这个原因是私人的。	not_entailment
这个原因是私人的。	这个原因是特别的。	not_entailment
亚历克斯是悲伤的。	亚历克斯是疲惫的。	not_entailment
亚历克斯是疲惫的。	亚历克斯是悲伤的。	not_entailment
这个想法是高效的。	这个想法是批判的。	not_entailment
这个想法是批判的。	这个想法是高效的。	not_entailment
这天气是糟糕的。	这天气是阴冷的。	not_entailment
这天气是阴冷的。	这天气是糟糕的。	not_entailment
这奥林匹克大会是悠久的。	这奥林匹克大会是重要的。	not_entailment
这奥林匹克大会是重要的。	这奥林匹克大会是悠久的。	not_entailment
内部是迷人的。	内部是神秘的。	not_entailment
内部是神秘的。	内部是迷人的。	not_entailment
这个底部是干净的。	这个底部是含糖的。	not_entailment
这个底部是含糖的。	这个底部是干净的。	not_entailment
这个海湾是漂亮的。	这个海湾是晴朗的。	not_entailment
这个海湾是晴朗的。	这个海湾是漂亮的。	not_entailment
这个小孩是明智的。	这个小孩是漂亮的。	not_entailment
这个小孩是漂亮的。	这个小孩是明智的。	not_entailment
这位市长是生气的。	这位市长是最佳的。	not_entailment
这位市长是最佳的。	这位市长是生气的。	not_entailment
这个真相是振奋的。	这个真相是痛苦的。	not_entailment
这个真相是痛苦的。	这个真相是振奋的。	not_entailment
亚历山大是可爱的。	亚历山大是肮脏的。	not_entailment
亚历山大是肮脏的。	亚历山大是可爱的。	not_entailment
这条小溪是漂亮的。	这条小溪是混浊的。	not_entailment
这条小溪是混浊的。	这条小溪是漂亮的。	not_entailment
这个信息是宝贵的。	这个信息是震惊的。	not_entailment
这个信息是震惊的。	这个信息是宝贵的。	not_entailment
这夜是凄凉的。	这夜是寂静的。	not_entailment
这夜是寂静的。	这夜是凄凉的。	not_entailment
这个景象是美好的。	这个景象是惊讶的。	not_entailment
这个景象是惊讶的。	这个景象是美好的。	not_entailment
这心脏是虚弱的。	这心脏是迟缓的。	not_entailment
这心脏是迟缓的。	这心脏是虚弱的。	not_entailment
这个游戏是缓慢的。	这个游戏是单调的。	not_entailment
这个游戏是单调的。	这个游戏是缓慢的。	not_entailment
这次供给是充足的。	这次供给是及时的。	not_entailment
这次供给是及时的。	这次供给是充足的。	not_entailment
这位君主是明智的。	这位君主是美丽的。	not_entailment
这位君主是美丽的。	这位君主是明智的。	not_entailment
这个房屋是丑陋的。	这个房屋是最佳的。	not_entailment
这个房屋是最佳的。	这个房屋是丑陋的。	not_entailment
这次逃跑是快速的。	这次逃跑是过激的。	not_entailment
这次逃跑是过激的。	这次逃跑是快速的。	not_entailment
这里面的是美好的。	这里面的是恐怖的。	not_entailment
这里面的是恐怖的。	这里面的是美好的。	not_entailment
这个出口是黑暗的。	这个出口是迅速的。	not_entailment
这个出口是迅速的。	这个出口是黑暗的。	not_entailment
这个结果是失望的。	这个结果是宝贵的。	not_entailment
这个结果是宝贵的。	这个结果是失望的。	not_entailment
这头水牛是肥胖的。	这头水牛是可怕的。	not_entailment
这头水牛是可怕的。	这头水牛是肥胖的。	not_entailment
这片树林是漂亮的。	这片树林是极冷的。	not_entailment
这片树林是极冷的。	这片树林是漂亮的。	not_entailment
这天气是炎热的。	这天气是少见的。	not_entailment
这天气是少见的。	这天气是炎热的。	not_entailment
这个公式是容易的。	这个公式是有趣的。	not_entailment
这个公式是有趣的。	这个公式是容易的。	not_entailment
这个化学成分是危险的。	这个化学成分是有机的。	not_entailment
这个化学成分是有机的。	这个化学成分是危险的。	not_entailment
这种是少见的。	这种是虚弱的。	not_entailment
这种是虚弱的。	这种是少见的。	not_entailment
这种关系是特别的。	这种关系是有趣的。	not_entailment
这种关系是有趣的。	这种关系是特别的。	not_entailment
这里面的是干净的。	这里面的是稀有的。	not_entailment
这里面的是稀有的。	这里面的是干净的。	not_entailment
这本书是悲伤的。	这本书是潮湿的。	not_entailment
这本书是潮湿的。	这本书是悲伤的。	not_entailment
这套西服是古怪的。	这套西服是黑色的。	not_entailment
这套西服是黑色的。	这套西服是古怪的。	not_entailment
这将来是恐怖的。	这将来是灰暗的。	not_entailment
这将来是灰暗的。	这将来是恐怖的。	not_entailment
这次聚会是热闹的。	这次聚会是危险的。	not_entailment
这次聚会是危险的。	这次聚会是热闹的。	not_entailment
这个真相是恐怖的。	这个真相是神秘的。	not_entailment
这个真相是神秘的。	这个真相是恐怖的。	not_entailment
这将来是危险的。	这将来是光明的。	not_entailment
这将来是光明的。	这将来是危险的。	not_entailment
这个演播室是阴暗的。	这个演播室是肮脏的。	not_entailment
这个演播室是肮脏的。	这个演播室是阴暗的。	not_entailment
这次运动是必要的。	这次运动是有效的。	not_entailment
这次运动是有效的。	这次运动是必要的。	not_entailment
这个标题是有趣的。	这个标题是恶心的。	not_entailment
这个标题是恶心的。	这个标题是有趣的。	not_entailment
这次休息是漫长的。	这次休息是轻松的。	not_entailment
这次休息是轻松的。	这次休息是漫长的。	not_entailment
这间别墅是老旧的。	这间别墅是宽阔的。	not_entailment
这间别墅是宽阔的。	这间别墅是老旧的。	not_entailment
这名成年女子是生气的。	这名成年女子是年轻的。	not_entailment
这名成年女子是年轻的。	这名成年女子是生气的。	not_entailment
这张地毯是干燥的。	这张地毯是显眼的。	not_entailment
这张地毯是显眼的。	这张地毯是干燥的。	not_entailment
这名君主是生气的。	这名君主是睿智的。	not_entailment
这名君主是睿智的。	这名君主是生气的。	not_entailment
这张相片是模糊的。	这张相片是彩色的。	not_entailment
这张相片是彩色的。	这张相片是模糊的。	not_entailment
这种记忆力是宝贵的。	这种记忆力是震惊的。	not_entailment
这种记忆力是震惊的。	这种记忆力是宝贵的。	not_entailment
这次谋杀是残忍的。	这次谋杀是预谋的。	not_entailment
这次谋杀是预谋的。	这次谋杀是残忍的。	not_entailment
这个机器是高效的。	这个机器是崭新的。	not_entailment
这个机器是崭新的。	这个机器是高效的。	not_entailment
这依据是奇怪的。	这依据是信服的。	not_entailment
这依据是信服的。	这依据是奇怪的。	not_entailment
这声音是糟糕的。	这声音是奇怪的。	not_entailment
这声音是奇怪的。	这声音是糟糕的。	not_entailment
这个房间是干燥的。	这个房间是老旧的。	not_entailment
这个房间是老旧的。	这个房间是干燥的。	not_entailment
这种车是量产的。	这种车是拉风的。	not_entailment
这种车是拉风的。	这种车是量产的。	not_entailment
这个人是活泼的。	这个人是肥胖的。	not_entailment
这个人是肥胖的。	这个人是活泼的。	not_entailment
这条河是肮脏的。	这条河是干涸的。	not_entailment
这条河是干涸的。	这条河是肮脏的。	not_entailment
这个房屋是怪异的。	这个房屋是老旧的。	not_entailment
这个房屋是老旧的。	这个房屋是怪异的。	not_entailment
这语气是古怪的。	这语气是糟糕的。	not_entailment
这语气是糟糕的。	这语气是古怪的。	not_entailment
这陶器是五彩的。	这陶器是精巧的。	not_entailment
这陶器是精巧的。	这陶器是五彩的。	not_entailment
这块冰是干净的。	这块冰是锋利的。	not_entailment
这块冰是锋利的。	这块冰是干净的。	not_entailment
这个山谷是漂亮的。	这个山谷是神秘的。	not_entailment
这个山谷是神秘的。	这个山谷是漂亮的。	not_entailment
这条连衣裙是漂亮的。	这条连衣裙是单调的。	not_entailment
这条连衣裙是单调的。	这条连衣裙是漂亮的。	not_entailment
这个助行器是高效的。	这个助行器是基本的。	not_entailment
这个助行器是基本的。	这个助行器是高效的。	not_entailment
这个计划是可行的。	这个计划是不好的。	not_entailment
这个计划是不好的。	这个计划是可行的。	not_entailment
这个相机是好用的。	这个相机是老旧的。	not_entailment
这个相机是老旧的。	这个相机是好用的。	not_entailment
吉米一家是快乐的。	吉米一家是古怪的。	not_entailment
吉米一家是古怪的。	吉米一家是快乐的。	not_entailment
这个卡通是滑稽的。	这个卡通是迷人的。	not_entailment
这个卡通是迷人的。	这个卡通是滑稽的。	not_entailment
这片土壤是肮脏的。	这片土壤是危险的。	not_entailment
这片土壤是危险的。	这片土壤是肮脏的。	not_entailment
亨泰是善良的。	亨泰是可怕的。	not_entailment
亨泰是可怕的。	亨泰是善良的。	not_entailment
这个头脑是聪明的。	这个头脑是敏捷的。	not_entailment
这个头脑是敏捷的。	这个头脑是聪明的。	not_entailment
这个房间是彩色的。	这个房间是宽敞的。	not_entailment
这个房间是宽敞的。	这个房间是彩色的。	not_entailment
这个房间是潮湿的。	这个房间是凌乱的。	not_entailment
这个房间是凌乱的。	这个房间是潮湿的。	not_entailment
这片草坪是潮湿的。	这片草坪是枯萎的。	not_entailment
这片草坪是枯萎的。	这片草坪是潮湿的。	not_entailment
这片网络是高效的。	这片网络是基本的。	not_entailment
这片网络是基本的。	这片网络是高效的。	not_entailment
这本书是可爱的。	这本书是短小的。	not_entailment
这本书是短小的。	这本书是可爱的。	not_entailment
这位先生是滑稽的。	这位先生是成熟的。	not_entailment
这位先生是成熟的。	这位先生是滑稽的。	not_entailment
这个集市是常见的。	这个集市是冷清的。	not_entailment
这个集市是冷清的。	这个集市是常见的。	not_entailment
这种机器人是高效的。	这种机器人是巨大的。	not_entailment
这种机器人是巨大的。	这种机器人是高效的。	not_entailment
这个休息室是宽敞的。	这个休息室是可爱的。	not_entailment
这个休息室是可爱的。	这个休息室是宽敞的。	not_entailment
这段历史是漫长的。	这段历史是绝望的。	not_entailment
这段历史是绝望的。	这段历史是漫长的。	not_entailment
这次战争是漫长的。	这次战争是快速的。	not_entailment
这次战争是快速的。	这次战争是漫长的。	not_entailment
这个集市是高效的。	这个集市是小型的。	not_entailment
这个集市是小型的。	这个集市是高效的。	not_entailment
这个家庭是快乐的。	这个家庭是人少的。	not_entailment
这个家庭是人少的。	这个家庭是快乐的。	not_entailment
这个圣诞节是悲伤的。	这个圣诞节是短暂的。	not_entailment
这个圣诞节是短暂的。	这个圣诞节是悲伤的。	not_entailment
这个奖是宝贵的。	这个奖是虚假的。	not_entailment
这个奖是虚假的。	这个奖是宝贵的。	not_entailment
这个看法是积极的。	这个看法是片面的。	not_entailment
这个看法是片面的。	这个看法是积极的。	not_entailment
这个老板是聪明的。	这个老板是完美的。	not_entailment
这个老板是完美的。	这个老板是聪明的。	not_entailment
这次治疗是昂贵的。	这次治疗是疼痛的。	not_entailment
这次治疗是疼痛的。	这次治疗是昂贵的。	not_entailment
这个世界是愤怒的。	这个世界是湿透的。	not_entailment
这个世界是湿透的。	这个世界是愤怒的。	not_entailment
这个论点是有限的。	这个论点是错误的。	not_entailment
这个论点是错误的。	这个论点是有限的。	not_entailment
这个集市是特殊的。	这个集市是美丽的。	not_entailment
这个集市是美丽的。	这个集市是特殊的。	not_entailment
这购买的是有趣的。	这购买的是古怪的。	not_entailment
这购买的是古怪的。	这购买的是有趣的。	not_entailment
这条路是干燥的。	这条路是泥泞的。	not_entailment
这条路是泥泞的。	这条路是干燥的。	not_entailment
这张票是昂贵的。	这张票是多余的。	not_entailment
这张票是多余的。	这张票是昂贵的。	not_entailment
这首音乐是活泼的。	这首音乐是出色的。	not_entailment
这首音乐是出色的。	这首音乐是活泼的。	not_entailment
这个宝贝是可爱的。	这个宝贝是有趣的。	not_entailment
这个宝贝是有趣的。	这个宝贝是可爱的。	not_entailment
这个气氛是危险的。	这个气氛是古怪的。	not_entailment
这个气氛是古怪的。	这个气氛是危险的。	not_entailment
这个场景是糟糕的。	这个场景是恐怖的。	not_entailment
这个场景是恐怖的。	这个场景是糟糕的。	not_entailment
这个主题是危险的。	这个主题是稀有的。	not_entailment
这个主题是稀有的。	这个主题是危险的。	not_entailment
这个消息是糟糕的。	这个消息是愉快的。	not_entailment
这个消息是愉快的。	这个消息是糟糕的。	not_entailment
这间别墅是美好的。	这间别墅是崭新的。	not_entailment
这间别墅是崭新的。	这间别墅是美好的。	not_entailment
这个主意是简单的。	这个主意是微小的。	not_entailment
这个主意是微小的。	这个主意是简单的。	not_entailment
这个门厅是拥挤的。	这个门厅是破败的。	not_entailment
这个门厅是破败的。	这个门厅是拥挤的。	not_entailment
这个气候是危险的。	这个气候是未知的。	not_entailment
这个气候是未知的。	这个气候是危险的。	not_entailment
这篇文章是凄凉的。	这篇文章是绝望的。	not_entailment
这篇文章是绝望的。	这篇文章是凄凉的。	not_entailment
这个答复是吓人的。	这个答复是不错的。	not_entailment
这个答复是不错的。	这个答复是吓人的。	not_entailment
这个小镇是安静的。	这个小镇是安定的。	not_entailment
这个小镇是安定的。	这个小镇是安静的。	not_entailment
这个结论是合适的。	这个结论是清晰的。	not_entailment
这个结论是清晰的。	这个结论是合适的。	not_entailment
这神谕是稀少的。	这神谕是睿智的。	not_entailment
这神谕是睿智的。	这神谕是稀少的。	not_entailment
这个消息是悲伤的。	这个消息是愉快的。	not_entailment
这个消息是愉快的。	这个消息是悲伤的。	not_entailment
这个处理是有效的。	这个处理是极好的。	not_entailment
这个处理是极好的。	这个处理是有效的。	not_entailment
这内部是潮湿的。	这内部是拥挤的。	not_entailment
这内部是拥挤的。	这内部是潮湿的。	not_entailment
这只芦苇是衰老的。	这只芦苇是干枯的。	not_entailment
这只芦苇是干枯的。	这只芦苇是衰老的。	not_entailment
这条项链是宝贵的。	这条项链是可爱的。	not_entailment
这条项链是可爱的。	这条项链是宝贵的。	not_entailment
这次机会是普通的。	这次机会是难得的。	not_entailment
这次机会是难得的。	这次机会是普通的。	not_entailment
这部电影是糟糕的。	这部电影是重要的。	not_entailment
这部电影是重要的。	这部电影是糟糕的。	not_entailment
这个陶器是古老的。	这个陶器是完美的。	not_entailment
这个陶器是完美的。	这个陶器是古老的。	not_entailment
这个形象是误导的。	这个形象是杰出的。	not_entailment
这个形象是杰出的。	这个形象是误导的。	not_entailment
这条记录是干净的。	这条记录是明智的。	not_entailment
这条记录是明智的。	这条记录是干净的。	not_entailment
这个dvd是损坏的。	这个dvd是私人的。	not_entailment
这个dvd是私人的。	这个dvd是损坏的。	not_entailment
这些装饰是糟糕的。	这些装饰是丰富的。	not_entailment
这些装饰是丰富的。	这些装饰是糟糕的。	not_entailment
这个邻居是丑陋的。	这个邻居是优秀的。	not_entailment
这个邻居是优秀的。	这个邻居是丑陋的。	not_entailment
这次发育是惊人的。	这次发育是良好的。	not_entailment
这次发育是良好的。	这次发育是惊人的。	not_entailment
这个结合体是美好的。	这个结合体是轻松的。	not_entailment
这个结合体是轻松的。	这个结合体是美好的。	not_entailment
这个房屋是潮湿的。	这个房屋是漏水的。	not_entailment
这个房屋是漏水的。	这个房屋是潮湿的。	not_entailment
这具身体是疲倦的。	这具身体是危险的。	not_entailment
这具身体是危险的。	这具身体是疲倦的。	not_entailment
这名医生是快乐的。	这名医生是可爱的。	not_entailment
这名医生是可爱的。	这名医生是快乐的。	not_entailment
这天是饥饿的。	这天是疲惫的。	not_entailment
这天是疲惫的。	这天是饥饿的。	not_entailment
这笔钱是有用的。	这笔钱是富余的。	not_entailment
这笔钱是富余的。	这笔钱是有用的。	not_entailment
这间咖啡馆是拥挤的。	这间咖啡馆是危险的。	not_entailment
这间咖啡馆是危险的。	这间咖啡馆是拥挤的。	not_entailment
这个想法是愚蠢的。	这个想法是恐怖的。	not_entailment
这个想法是恐怖的。	这个想法是愚蠢的。	not_entailment
这个位置是潮湿的。	这个位置是难看的。	not_entailment
这个位置是难看的。	这个位置是潮湿的。	not_entailment
这个地板是潮湿的。	这个地板是破旧的。	not_entailment
这个地板是破旧的。	这个地板是潮湿的。	not_entailment
这名总统是聪明的。	这名总统是少见的。	not_entailment
这名总统是少见的。	这名总统是聪明的。	not_entailment
吉米一家是善良的。	吉米一家是少见的。	not_entailment
吉米一家是少见的。	吉米一家是善良的。	not_entailment
这个男人是滑稽的。	这个男人是消瘦的。	not_entailment
这个男人是消瘦的。	这个男人是滑稽的。	not_entailment
这个曲调是合适的。	这个曲调是最佳的。	not_entailment
这个曲调是最佳的。	这个曲调是合适的。	not_entailment
这年是快乐的。	这年是丰富的。	not_entailment
这年是丰富的。	这年是快乐的。	not_entailment
这块土砖是潮湿的。	这块土砖是损坏的。	not_entailment
这块土砖是损坏的。	这块土砖是潮湿的。	not_entailment
这种古罗马物件是少见的。	这种古罗马物件是虚假的。	not_entailment
这种古罗马物件是虚假的。	这种古罗马物件是少见的。	not_entailment
这个世界是拥挤的。	这个世界是寒冷的。	not_entailment
这个世界是寒冷的。	这个世界是拥挤的。	not_entailment
这只老鼠是疲倦的。	这只老鼠是附近的。	not_entailment
这只老鼠是附近的。	这只老鼠是疲倦的。	not_entailment
这个市场是活跃的。	这个市场是疲软的。	not_entailment
这个市场是疲软的。	这个市场是活跃的。	not_entailment
这次预测是清晰的。	这次预测是困难的。	not_entailment
这次预测是困难的。	这次预测是清晰的。	not_entailment
这个单词是悲伤的。	这个单词是熟练的。	not_entailment
这个单词是熟练的。	这个单词是悲伤的。	not_entailment
这个角度是古怪的。	这个角度是巨大的。	not_entailment
这个角度是巨大的。	这个角度是古怪的。	not_entailment
这个问题是个人的。	这个问题是危险的。	not_entailment
这个问题是危险的。	这个问题是个人的。	not_entailment
这次烹饪是快速的。	这次烹饪是糟糕的。	not_entailment
这次烹饪是糟糕的。	这次烹饪是快速的。	not_entailment
这次使用是合适的。	这次使用是有效的。	not_entailment
这次使用是有效的。	这次使用是合适的。	not_entailment
这个村庄是安静的。	这个村庄是宜居的。	not_entailment
这个村庄是宜居的。	这个村庄是安静的。	not_entailment
这空气是香甜的。	这空气是污浊的。	not_entailment
这空气是污浊的。	这空气是香甜的。	not_entailment
这个肥皂是巨大的。	这个肥皂是香香的。	not_entailment
这个肥皂是香香的。	这个肥皂是巨大的。	not_entailment
这个原因是简单的。	这个原因是严肃的。	not_entailment
这个原因是严肃的。	这个原因是简单的。	not_entailment
这名工作人员是失望的。	这名工作人员是饥饿的。	not_entailment
这名工作人员是饥饿的。	这名工作人员是失望的。	not_entailment
这替代品是危险的。	这替代品是纯净的。	not_entailment
这替代品是纯净的。	这替代品是危险的。	not_entailment
这国政府是生气的。	这国政府是绝望的。	not_entailment
这国政府是绝望的。	这国政府是生气的。	not_entailment
这头狮子是饥饿的。	这头狮子是可怕的。	not_entailment
这头狮子是可怕的。	这头狮子是饥饿的。	not_entailment
这个公爵是可爱的。	这个公爵是忙碌的。	not_entailment
这个公爵是忙碌的。	这个公爵是可爱的。	not_entailment
这种技巧是高效的。	这种技巧是明智的。	not_entailment
这种技巧是明智的。	这种技巧是高效的。	not_entailment
这个球是潮湿的。	这个球是可爱的。	not_entailment
这个球是可爱的。	这个球是潮湿的。	not_entailment
这个希腊人是特别的。	这个希腊人是有趣的。	not_entailment
这个希腊人是有趣的。	这个希腊人是特别的。	not_entailment
这本书是有趣的。	这本书是丰富的。	not_entailment
这本书是丰富的。	这本书是有趣的。	not_entailment
这个dvd是简易的。	这个dvd是损坏的。	not_entailment
这个dvd是损坏的。	这个dvd是简易的。	not_entailment
史密斯一家是辛苦的。	史密斯一家是绝望的。	not_entailment
史密斯一家是绝望的。	史密斯一家是辛苦的。	not_entailment
这个平民是失望的。	这个平民是疲倦的。	not_entailment
这个平民是疲倦的。	这个平民是失望的。	not_entailment
吉米一家是坚韧的。	吉米一家是惊讶的。	not_entailment
吉米一家是惊讶的。	吉米一家是坚韧的。	not_entailment
这个过渡是快速的。	这个过渡是明智的。	not_entailment
这个过渡是明智的。	这个过渡是快速的。	not_entailment
这部浪漫片是甜蜜的。	这部浪漫片是唯美的。	not_entailment
这部浪漫片是唯美的。	这部浪漫片是甜蜜的。	not_entailment
这个标题是恐怖的。	这个标题是可怕的。	not_entailment
这个标题是可怕的。	这个标题是恐怖的。	not_entailment
这片芦苇是狭小的。	这片芦苇是茂密的。	not_entailment
这片芦苇是茂密的。	这片芦苇是狭小的。	not_entailment
这只猫是快乐的。	这只猫是古怪的。	not_entailment
这只猫是古怪的。	这只猫是快乐的。	not_entailment
这个工作是繁重的。	这个工作是重要的。	not_entailment
这个工作是重要的。	这个工作是繁重的。	not_entailment
这个dvd是危险的。	这个dvd是漫长的。	not_entailment
这个dvd是漫长的。	这个dvd是危险的。	not_entailment
这个男人是坚韧的。	这个男人是痴迷的。	not_entailment
这个男人是痴迷的。	这个男人是坚韧的。	not_entailment
这个演播室是安静的。	这个演播室是活跃的。	not_entailment
这个演播室是活跃的。	这个演播室是安静的。	not_entailment
这片水塘是漂亮的。	这片水塘是清澈的。	not_entailment
这片水塘是清澈的。	这片水塘是漂亮的。	not_entailment
这名金发女郎是迷人的。	这名金发女郎是高兴的。	not_entailment
这名金发女郎是高兴的。	这名金发女郎是迷人的。	not_entailment
这个小孩是漂亮的。	这个小孩是淘气的。	not_entailment
这个小孩是淘气的。	这个小孩是漂亮的。	not_entailment
这个国家是昌盛的。	这个国家是危险的。	not_entailment
这个国家是危险的。	这个国家是昌盛的。	not_entailment
这个摄像机是老旧的。	这个摄像机是智能的。	not_entailment
这个摄像机是智能的。	这个摄像机是老旧的。	not_entailment
这个菜单是丰富的。	这个菜单是直白的。	not_entailment
这个菜单是直白的。	这个菜单是丰富的。	not_entailment
这种情况是不好的。	这种情况是可怕的。	not_entailment
这种情况是可怕的。	这种情况是不好的。	not_entailment
这未来是困难的。	这未来是迷茫的。	not_entailment
这未来是迷茫的。	这未来是困难的。	not_entailment
这个机器是能干的。	这个机器是老旧的。	not_entailment
这个机器是老旧的。	这个机器是能干的。	not_entailment
这部电影是滑稽的。	这部电影是震撼的。	not_entailment
这部电影是震撼的。	这部电影是滑稽的。	not_entailment
这个位置是危险的。	这个位置是狭窄的。	not_entailment
这个位置是狭窄的。	这个位置是危险的。	not_entailment
这个指向是清晰的。	这个指向是深刻的。	not_entailment
这个指向是深刻的。	这个指向是清晰的。	not_entailment
这间别墅是个人的。	这间别墅是昂贵的。	not_entailment
这间别墅是昂贵的。	这间别墅是个人的。	not_entailment
这个联盟是虚弱的。	这个联盟是巨大的。	not_entailment
这个联盟是巨大的。	这个联盟是虚弱的。	not_entailment
这种花是少见的。	这种花是朴素的。	not_entailment
这种花是朴素的。	这种花是少见的。	not_entailment
这把盐是美味的。	这把盐是普通的。	not_entailment
这把盐是普通的。	这把盐是美味的。	not_entailment
这个厨房是拥挤的。	这个厨房是可爱的。	not_entailment
这个厨房是可爱的。	这个厨房是拥挤的。	not_entailment
这个意图是重要的。	这个意图是积极的。	not_entailment
这个意图是积极的。	这个意图是重要的。	not_entailment
这互联网是必需的。	这互联网是热闹的。	not_entailment
这互联网是热闹的。	这互联网是必需的。	not_entailment
这个态度是积极的。	这个态度是模糊的。	not_entailment
这个态度是模糊的。	这个态度是积极的。	not_entailment
这具身体是高效的。	这具身体是疲倦的。	not_entailment
这具身体是疲倦的。	这具身体是高效的。	not_entailment
路易斯一家是漂亮的。	路易斯一家是湿透的。	not_entailment
路易斯一家是湿透的。	路易斯一家是漂亮的。	not_entailment
这珠宝是闪亮的。	这珠宝是宝贵的。	not_entailment
这珠宝是宝贵的。	这珠宝是闪亮的。	not_entailment
这个别墅是高大的。	这个别墅是古老的。	not_entailment
这个别墅是古老的。	这个别墅是高大的。	not_entailment
这个差别是惊人的。	这个差别是可怕的。	not_entailment
这个差别是可怕的。	这个差别是惊人的。	not_entailment
这名购物者是担心的。	这名购物者是美丽的。	not_entailment
这名购物者是美丽的。	这名购物者是担心的。	not_entailment
这些庄稼是成熟的。	这些庄稼是极好的。	not_entailment
这些庄稼是极好的。	这些庄稼是成熟的。	not_entailment
这个陈述是误导的。	这个陈述是晦涩的。	not_entailment
这个陈述是晦涩的。	这个陈述是误导的。	not_entailment
这扇窗是肮脏的。	这扇窗是拥挤的。	not_entailment
这扇窗是拥挤的。	这扇窗是肮脏的。	not_entailment
这个公园是美好的。	这个公园是伪造的。	not_entailment
这个公园是伪造的。	这个公园是美好的。	not_entailment
这名教师是快乐的。	这名教师是肥胖的。	not_entailment
这名教师是肥胖的。	这名教师是快乐的。	not_entailment
这部电影是滑稽的。	这部电影是肮脏的。	not_entailment
这部电影是肮脏的。	这部电影是滑稽的。	not_entailment
这名君主是肥胖的。	这名君主是贤明的。	not_entailment
这名君主是贤明的。	这名君主是肥胖的。	not_entailment
这种人是少见的。	这种人是危险的。	not_entailment
这种人是危险的。	这种人是少见的。	not_entailment
这个成年女子是迷人的。	这个成年女子是阴暗的。	not_entailment
这个成年女子是阴暗的。	这个成年女子是迷人的。	not_entailment
这匹马是可爱的。	这匹马是可怕的。	not_entailment
这匹马是可怕的。	这匹马是可爱的。	not_entailment
这个陶器是微型的。	这个陶器是可怕的。	not_entailment
这个陶器是可怕的。	这个陶器是微型的。	not_entailment
这名医生是生气的。	这名医生是肮脏的。	not_entailment
这名医生是肮脏的。	这名医生是生气的。	not_entailment
这现实是悲伤的。	这现实是可憎的。	not_entailment
这现实是可憎的。	这现实是悲伤的。	not_entailment
史密斯一家是担心的。	史密斯一家是凶残的。	not_entailment
史密斯一家是凶残的。	史密斯一家是担心的。	not_entailment
这个激光是高效的。	这个激光是耀眼的。	not_entailment
这个激光是耀眼的。	这个激光是高效的。	not_entailment
这最低限度是必需的。	这最低限度是勉强的。	not_entailment
这最低限度是勉强的。	这最低限度是必需的。	not_entailment
这块肉是美味的。	这块肉是肥厚的。	not_entailment
这块肉是肥厚的。	这块肉是美味的。	not_entailment
这个气氛是平淡的。	这个气氛是活跃的。	not_entailment
这个气氛是活跃的。	这个气氛是平淡的。	not_entailment
这首歌曲是恐怖的。	这首歌曲是疯癫的。	not_entailment
这首歌曲是疯癫的。	这首歌曲是恐怖的。	not_entailment
这种感觉是悲伤的。	这种感觉是生气的。	not_entailment
这种感觉是生气的。	这种感觉是悲伤的。	not_entailment
这打手是邪恶的。	这打手是强壮的。	not_entailment
这打手是强壮的。	这打手是邪恶的。	not_entailment
这个门厅是暗淡的。	这个门厅是潮湿的。	not_entailment
这个门厅是潮湿的。	这个门厅是暗淡的。	not_entailment
这块甲板是潮湿的。	这块甲板是糟糕的。	not_entailment
这块甲板是糟糕的。	这块甲板是潮湿的。	not_entailment
这片海滩是热闹的。	这片海滩是危险的。	not_entailment
这片海滩是危险的。	这片海滩是热闹的。	not_entailment
这个世界是智慧的。	这个世界是可憎的。	not_entailment
这个世界是可憎的。	这个世界是智慧的。	not_entailment
这个男性是成熟的。	这个男性是沮丧的。	not_entailment
这个男性是沮丧的。	这个男性是成熟的。	not_entailment
这时机是成熟的。	这时机是错误的。	not_entailment
这时机是错误的。	这时机是成熟的。	not_entailment
这条狗是肥胖的。	这条狗是聪明的。	not_entailment
这条狗是聪明的。	这条狗是肥胖的。	not_entailment
这个陶器是著名的。	这个陶器是精美的。	not_entailment
这个陶器是精美的。	这个陶器是著名的。	not_entailment
这本小册子是短小的。	这本小册子是丰富的。	not_entailment
这本小册子是丰富的。	这本小册子是短小的。	not_entailment
这个部门是成熟的。	这个部门是糟糕的。	not_entailment
这个部门是糟糕的。	这个部门是成熟的。	not_entailment
这个珠宝是老旧的。	这个珠宝是滑稽的。	not_entailment
这个珠宝是滑稽的。	这个珠宝是老旧的。	not_entailment
这个替代品是损坏的。	这个替代品是悲惨的。	not_entailment
这个替代品是悲惨的。	这个替代品是损坏的。	not_entailment
这外表是恐怖的。	这外表是可爱的。	not_entailment
这外表是可爱的。	这外表是恐怖的。	not_entailment
这个人是成熟的。	这个人是正义的。	not_entailment
这个人是正义的。	这个人是成熟的。	not_entailment
这名顾客是生气的。	这名顾客是自私的。	not_entailment
这名顾客是自私的。	这名顾客是生气的。	not_entailment
这个图案是特别的。	这个图案是可怕的。	not_entailment
这个图案是可怕的。	这个图案是特别的。	not_entailment
这个技术是高效的。	这个技术是惊人的。	not_entailment
这个技术是惊人的。	这个技术是高效的。	not_entailment
这个设计是可爱的。	这个设计是迷人的。	not_entailment
这个设计是迷人的。	这个设计是可爱的。	not_entailment
这位公主是快乐的。	这位公主是纯洁的。	not_entailment
这位公主是纯洁的。	这位公主是快乐的。	not_entailment
这之后是暴力的。	这之后是危险的。	not_entailment
这之后是危险的。	这之后是暴力的。	not_entailment
这个标题是误导的。	这个标题是宝贵的。	not_entailment
这个标题是宝贵的。	这个标题是误导的。	not_entailment
这个结尾是合适的。	这个结尾是美好的。	not_entailment
这个结尾是美好的。	这个结尾是合适的。	not_entailment
这些奋斗是必需的。	这些奋斗是微小的。	not_entailment
这些奋斗是微小的。	这些奋斗是必需的。	not_entailment
这片树林是贫穷的。	这片树林是拥挤的。	not_entailment
这片树林是拥挤的。	这片树林是贫穷的。	not_entailment
这片土地是宽阔的。	这片土地是肥沃的。	not_entailment
这片土地是肥沃的。	这片土地是宽阔的。	not_entailment
这里面是美好的。	这里面是含糖的。	not_entailment
这里面是含糖的。	这里面是美好的。	not_entailment
这种音乐是嘈杂的。	这种音乐是少有的。	not_entailment
这种音乐是少有的。	这种音乐是嘈杂的。	not_entailment
这个院子是肮脏的。	这个院子是迷人的。	not_entailment
这个院子是迷人的。	这个院子是肮脏的。	not_entailment
这张相片是可爱的。	这张相片是黑白的。	not_entailment
这张相片是黑白的。	这张相片是可爱的。	not_entailment
这个看法是深刻的。	这个看法是有趣的。	not_entailment
这个看法是有趣的。	这个看法是深刻的。	not_entailment
这部电影是悲伤的。	这部电影是极好的。	not_entailment
这部电影是极好的。	这部电影是悲伤的。	not_entailment
这只猫是滑稽的。	这只猫是可爱的。	not_entailment
这只猫是可爱的。	这只猫是滑稽的。	not_entailment
这个解决方案是罕见的。	这个解决方案是成熟的。	not_entailment
这个解决方案是成熟的。	这个解决方案是罕见的。	not_entailment
史密斯一家是忧愁的。	史密斯一家是干净的。	not_entailment
史密斯一家是干净的。	史密斯一家是忧愁的。	not_entailment
这发展是积极的。	这发展是危险的。	not_entailment
这发展是危险的。	这发展是积极的。	not_entailment
这次联盟是有趣的。	这次联盟是糟糕的。	not_entailment
这次联盟是糟糕的。	这次联盟是有趣的。	not_entailment
这个真相是重要的。	这个真相是滑稽的。	not_entailment
这个真相是滑稽的。	这个真相是重要的。	not_entailment
这面油漆是肮脏的。	这面油漆是五彩的。	not_entailment
这面油漆是五彩的。	这面油漆是肮脏的。	not_entailment
这次供给是应急的。	这次供给是危险的。	not_entailment
这次供给是危险的。	这次供给是应急的。	not_entailment
这个城市是拥挤的。	这个城市是美好的。	not_entailment
这个城市是美好的。	这个城市是拥挤的。	not_entailment
这名法官是明智的。	这名法官是邪恶的。	not_entailment
这名法官是邪恶的。	这名法官是明智的。	not_entailment
这个颜色是漂亮的。	这个颜色是闪亮的。	not_entailment
这个颜色是闪亮的。	这个颜色是漂亮的。	not_entailment
这些话语是悲伤的。	这些话语是宽慰的。	not_entailment
这些话语是宽慰的。	这些话语是悲伤的。	not_entailment
这商业是成熟的。	这商业是可怕的。	not_entailment
这商业是可怕的。	这商业是成熟的。	not_entailment
这个作用是高效的。	这个作用是无价的。	not_entailment
这个作用是无价的。	这个作用是高效的。	not_entailment
这疼痛是糟糕的。	这疼痛是饥饿的。	not_entailment
这疼痛是饥饿的。	这疼痛是糟糕的。	not_entailment
这名总统是虚弱的。	这名总统是古怪的。	not_entailment
这名总统是古怪的。	这名总统是虚弱的。	not_entailment
这个联盟是正义的。	这个联盟是热情的。	not_entailment
这个联盟是热情的。	这个联盟是正义的。	not_entailment
这个称谓是著名的。	这个称谓是少见的。	not_entailment
这个称谓是少见的。	这个称谓是著名的。	not_entailment
这个单词是怪异的。	这个单词是冰冷的。	not_entailment
这个单词是冰冷的。	这个单词是怪异的。	not_entailment
这次狂欢是尽兴的。	这次狂欢是疯狂的。	not_entailment
这次狂欢是疯狂的。	这次狂欢是尽兴的。	not_entailment
这个概念是可爱的。	这个概念是可怕的。	not_entailment
这个概念是可怕的。	这个概念是可爱的。	not_entailment
这个主题是有趣的。	这个主题是潮湿的。	not_entailment
这个主题是潮湿的。	这个主题是有趣的。	not_entailment
这个顺序是合适的。	这个顺序是极好的。	not_entailment
这个顺序是极好的。	这个顺序是合适的。	not_entailment
这些经验是不足的。	这些经验是有趣的。	not_entailment
这些经验是有趣的。	这些经验是不足的。	not_entailment
这种感觉是凄凉的。	这种感觉是热烈的。	not_entailment
这种感觉是热烈的。	这种感觉是凄凉的。	not_entailment
这数学是容易的。	这数学是复杂的。	not_entailment
这数学是复杂的。	这数学是容易的。	not_entailment
这个系统是疯狂的。	这个系统是贫困的。	not_entailment
这个系统是贫困的。	这个系统是疯狂的。	not_entailment
这名购物者是饥饿的。	这名购物者是睿智的。	not_entailment
这名购物者是睿智的。	这名购物者是饥饿的。	not_entailment
这个世界是快乐的。	这个世界是恶心的。	not_entailment
这个世界是恶心的。	这个世界是快乐的。	not_entailment
这个陶器是迷人的。	这个陶器是恐怖的。	not_entailment
这个陶器是恐怖的。	这个陶器是迷人的。	not_entailment
这个任务是困难的。	这个任务是巧妙的。	not_entailment
这个任务是巧妙的。	这个任务是困难的。	not_entailment
这顶部是干净的。	这顶部是巧妙的。	not_entailment
这顶部是巧妙的。	这顶部是干净的。	not_entailment
路易斯一家是虚弱的。	路易斯一家是可怕的。	not_entailment
路易斯一家是可怕的。	路易斯一家是虚弱的。	not_entailment
这名农民是疲倦的。	这名农民是开心的。	not_entailment
这名农民是开心的。	这名农民是疲倦的。	not_entailment
这个蓝牙是智能的。	这个蓝牙是高效的。	not_entailment
这个蓝牙是高效的。	这个蓝牙是智能的。	not_entailment
布兰妮是可爱的。	布兰妮是疯癫的。	not_entailment
布兰妮是疯癫的。	布兰妮是可爱的。	not_entailment
这批木材是干燥的。	这批木材是结实的。	not_entailment
这批木材是结实的。	这批木材是干燥的。	not_entailment
这个桶是红色的。	这个桶是好用的。	not_entailment
这个桶是好用的。	这个桶是红色的。	not_entailment
这个地板是干燥的。	这个地板是恶心的。	not_entailment
这个地板是恶心的。	这个地板是干燥的。	not_entailment
这种感觉是怪异的。	这种感觉是拥挤的。	not_entailment
这种感觉是拥挤的。	这种感觉是怪异的。	not_entailment
这个气氛是压抑的。	这个气氛是绝望的。	not_entailment
这个气氛是绝望的。	这个气氛是压抑的。	not_entailment
这个水果是苦涩的。	这个水果是脱水的。	not_entailment
这个水果是脱水的。	这个水果是苦涩的。	not_entailment
这个工作是容易的。	这个工作是繁杂的。	not_entailment
这个工作是繁杂的。	这个工作是容易的。	not_entailment
这个门厅是热闹的。	这个门厅是漂亮的。	not_entailment
这个门厅是漂亮的。	这个门厅是热闹的。	not_entailment
这片树林是特别的。	这片树林是可怕的。	not_entailment
这片树林是可怕的。	这片树林是特别的。	not_entailment
这些资产是宝贵的。	这些资产是稀有的。	not_entailment
这些资产是稀有的。	这些资产是宝贵的。	not_entailment
这片土壤是寒冷的。	这片土壤是干涸的。	not_entailment
这片土壤是干涸的。	这片土壤是寒冷的。	not_entailment
这次烹饪是成功的。	这次烹饪是黑暗的。	not_entailment
这次烹饪是黑暗的。	这次烹饪是成功的。	not_entailment
这条大街是潮湿的。	这条大街是公共的。	not_entailment
这条大街是公共的。	这条大街是潮湿的。	not_entailment
这条狗是疲倦的。	这条狗是完美的。	not_entailment
这条狗是完美的。	这条狗是疲倦的。	not_entailment
亚历山大是重要的。	亚历山大是可憎的。	not_entailment
亚历山大是可憎的。	亚历山大是重要的。	not_entailment
这次选择是困难的。	这次选择是微小的。	not_entailment
这次选择是微小的。	这次选择是困难的。	not_entailment
这个联盟是团结的。	这个联盟是大型的。	not_entailment
这个联盟是大型的。	这个联盟是团结的。	not_entailment
这个间谍是聪明的。	这个间谍是可怕的。	not_entailment
这个间谍是可怕的。	这个间谍是聪明的。	not_entailment
这个男人是烦人的。	这个男人是怕冷的。	not_entailment
这个男人是怕冷的。	这个男人是烦人的。	not_entailment
这个小孩是肥胖的。	这个小孩是高兴的。	not_entailment
这个小孩是高兴的。	这个小孩是肥胖的。	not_entailment
这次移动是明智的。	这次移动是安静的。	not_entailment
这次移动是安静的。	这次移动是明智的。	not_entailment
这个站台是宝贵的。	这个站台是可怕的。	not_entailment
这个站台是可怕的。	这个站台是宝贵的。	not_entailment
这个小孩是坚韧的。	这个小孩是重要的。	not_entailment
这个小孩是重要的。	这个小孩是坚韧的。	not_entailment
这声噪音是大声的。	这声噪音是奇怪的。	not_entailment
这声噪音是奇怪的。	这声噪音是大声的。	not_entailment
这动物是古怪的。	这动物是肥胖的。	not_entailment
这动物是肥胖的。	这动物是古怪的。	not_entailment
这个情节是凄凉的。	这个情节是迷人的。	not_entailment
这个情节是迷人的。	这个情节是凄凉的。	not_entailment
这首歌曲是愉快的。	这首歌曲是过分的。	not_entailment
这首歌曲是过分的。	这首歌曲是愉快的。	not_entailment
这张床是美好的。	这张床是陈旧的。	not_entailment
这张床是陈旧的。	这张床是美好的。	not_entailment
这表面是干净的。	这表面是沉默的。	not_entailment
这表面是沉默的。	这表面是干净的。	not_entailment
史密斯一家是消瘦的。	史密斯一家是可爱的。	not_entailment
史密斯一家是可爱的。	史密斯一家是消瘦的。	not_entailment
这种方法是高效的。	这种方法是愚蠢的。	not_entailment
这种方法是愚蠢的。	这种方法是高效的。	not_entailment
这个厨房是高效的。	这个厨房是极好的。	not_entailment
这个厨房是极好的。	这个厨房是高效的。	not_entailment
这个陶器是精巧的。	这个陶器是古老的。	not_entailment
这个陶器是古老的。	这个陶器是精巧的。	not_entailment
这个集市是热闹的。	这个集市是肮脏的。	not_entailment
这个集市是肮脏的。	这个集市是热闹的。	not_entailment
这条路径是危险的。	这条路径是可怕的。	not_entailment
这条路径是可怕的。	这条路径是危险的。	not_entailment
这个老板是快乐的。	这个老板是恐怖的。	not_entailment
这个老板是恐怖的。	这个老板是快乐的。	not_entailment
这个数字是误导的。	这个数字是极好的。	not_entailment
这个数字是极好的。	这个数字是误导的。	not_entailment
这块斜纹棉布是漂亮的。	这块斜纹棉布是厚实的。	not_entailment
这块斜纹棉布是厚实的。	这块斜纹棉布是漂亮的。	not_entailment
史密斯一家是虚弱的。	史密斯一家是多疑的。	not_entailment
史密斯一家是多疑的。	史密斯一家是虚弱的。	not_entailment
这个答复是悲伤的。	这个答复是平常的。	not_entailment
这个答复是平常的。	这个答复是悲伤的。	not_entailment
这种差异是不好的。	这种差异是少见的。	not_entailment
这种差异是少见的。	这种差异是不好的。	not_entailment
这种情绪是凄凉的。	这种情绪是痴迷的。	not_entailment
这种情绪是痴迷的。	这种情绪是凄凉的。	not_entailment
这个系统是糟糕的。	这个系统是成熟的。	not_entailment
这个系统是成熟的。	这个系统是糟糕的。	not_entailment
这段历史是个人的。	这段历史是迷人的。	not_entailment
这段历史是迷人的。	这段历史是个人的。	not_entailment
这次旅行是短暂的。	这次旅行是绝望的。	not_entailment
这次旅行是绝望的。	这次旅行是短暂的。	not_entailment
这次活动是必需的。	这次活动是极好的。	not_entailment
这次活动是极好的。	这次活动是必需的。	not_entailment
这个答复是简单的。	这个答复是奇怪的。	not_entailment
这个答复是奇怪的。	这个答复是简单的。	not_entailment
这位公爵是快乐的。	这位公爵是虚弱的。	not_entailment
这位公爵是虚弱的。	这位公爵是快乐的。	not_entailment
这些能量是充足的。	这些能量是单一的。	not_entailment
这些能量是单一的。	这些能量是充足的。	not_entailment
这个角度是合适的。	这个角度是奇怪的。	not_entailment
这个角度是奇怪的。	这个角度是合适的。	not_entailment
这个磨光机是高效的。	这个磨光机是干燥的。	not_entailment
这个磨光机是干燥的。	这个磨光机是高效的。	not_entailment
这个女孩是漂亮的。	这个女孩是完美的。	not_entailment
这个女孩是完美的。	这个女孩是漂亮的。	not_entailment
这个替代品是彩色的。	这个替代品是精巧的。	not_entailment
这个替代品是精巧的。	这个替代品是彩色的。	not_entailment
这片湖水是滚烫的。	这片湖水是澄澈的。	not_entailment
这片湖水是澄澈的。	这片湖水是滚烫的。	not_entailment
这次下落是快速的。	这次下落是欢快的。	not_entailment
这次下落是欢快的。	这次下落是快速的。	not_entailment
这个女孩是快乐的。	这个女孩是极美的。	not_entailment
这个女孩是极美的。	这个女孩是快乐的。	not_entailment
这种行为是古怪的。	这种行为是疯癫的。	not_entailment
这种行为是疯癫的。	这种行为是古怪的。	not_entailment
这只老鼠是饥饿的。	这只老鼠是寒冷的。	not_entailment
这只老鼠是寒冷的。	这只老鼠是饥饿的。	not_entailment
这个概念是古怪的。	这个概念是合适的。	not_entailment
这个概念是合适的。	这个概念是古怪的。	not_entailment
这个杯子是肮脏的。	这个杯子是损坏的。	not_entailment
这个杯子是损坏的。	这个杯子是肮脏的。	not_entailment
这床被子是难闻的。	这床被子是陈旧的。	not_entailment
这床被子是陈旧的。	这床被子是难闻的。	not_entailment